金贵银业	COMPANY_OF_INDUSTRY_0
赤峰黄金	COMPANY_OF_INDUSTRY_0
恒邦股份	COMPANY_OF_INDUSTRY_0
山东黄金	COMPANY_OF_INDUSTRY_0
园城黄金	COMPANY_OF_INDUSTRY_0
荣华实业	COMPANY_OF_INDUSTRY_0
西部黄金	COMPANY_OF_INDUSTRY_0
紫金矿业	COMPANY_OF_INDUSTRY_0
山东金泰	COMPANY_OF_INDUSTRY_0
中金黄金	COMPANY_OF_INDUSTRY_0
刚泰控股	COMPANY_OF_INDUSTRY_0
湖南黄金	COMPANY_OF_INDUSTRY_0
中润资源	COMPANY_OF_INDUSTRY_0
春秋航空	COMPANY_OF_INDUSTRY_1
吉祥航空	COMPANY_OF_INDUSTRY_1
南方航空	COMPANY_OF_INDUSTRY_1
海南航空	COMPANY_OF_INDUSTRY_1
中信海直	COMPANY_OF_INDUSTRY_1
中国国航	COMPANY_OF_INDUSTRY_1
厦门空港	COMPANY_OF_INDUSTRY_1
东方航空	COMPANY_OF_INDUSTRY_1
白云机场	COMPANY_OF_INDUSTRY_1
深圳机场	COMPANY_OF_INDUSTRY_1
上海机场	COMPANY_OF_INDUSTRY_1
国脉科技	COMPANY_OF_INDUSTRY_2
二六三	COMPANY_OF_INDUSTRY_2
光环新网	COMPANY_OF_INDUSTRY_2
中国联通	COMPANY_OF_INDUSTRY_2
鹏博士	COMPANY_OF_INDUSTRY_2
华控赛格	COMPANY_OF_INDUSTRY_3
迪森股份	COMPANY_OF_INDUSTRY_3
先河环保	COMPANY_OF_INDUSTRY_3
三维丝	COMPANY_OF_INDUSTRY_3
碧水源	COMPANY_OF_INDUSTRY_3
中国天楹	COMPANY_OF_INDUSTRY_3
清新环境	COMPANY_OF_INDUSTRY_3
中电环保	COMPANY_OF_INDUSTRY_3
伟明环保	COMPANY_OF_INDUSTRY_3
科融环境	COMPANY_OF_INDUSTRY_3
巴安水务	COMPANY_OF_INDUSTRY_3
永清环保	COMPANY_OF_INDUSTRY_3
远达环保	COMPANY_OF_INDUSTRY_3
津膜科技	COMPANY_OF_INDUSTRY_3
东江环保	COMPANY_OF_INDUSTRY_3
易世达	COMPANY_OF_INDUSTRY_3
高能环境	COMPANY_OF_INDUSTRY_3
维尔利	COMPANY_OF_INDUSTRY_3
启迪桑德	COMPANY_OF_INDUSTRY_3
秦岭水泥	COMPANY_OF_INDUSTRY_3
博世科	COMPANY_OF_INDUSTRY_3
盛运环保	COMPANY_OF_INDUSTRY_3
万邦达	COMPANY_OF_INDUSTRY_3
富春环保	COMPANY_OF_INDUSTRY_3
天壕环境	COMPANY_OF_INDUSTRY_3
环能科技	COMPANY_OF_INDUSTRY_3
中材节能	COMPANY_OF_INDUSTRY_3
神雾环保	COMPANY_OF_INDUSTRY_3
美尚生态	COMPANY_OF_INDUSTRY_3
新纶科技	COMPANY_OF_INDUSTRY_3
古越龙山	COMPANY_OF_INDUSTRY_4
中葡股份	COMPANY_OF_INDUSTRY_4
啤酒花	COMPANY_OF_INDUSTRY_4
重庆啤酒	COMPANY_OF_INDUSTRY_4
伊力特	COMPANY_OF_INDUSTRY_4
金种子酒	COMPANY_OF_INDUSTRY_4
海南椰岛	COMPANY_OF_INDUSTRY_4
通葡股份	COMPANY_OF_INDUSTRY_4
贵州茅台	COMPANY_OF_INDUSTRY_4
莫高股份	COMPANY_OF_INDUSTRY_4
老白干酒	COMPANY_OF_INDUSTRY_4
惠泉啤酒	COMPANY_OF_INDUSTRY_4
青岛啤酒	COMPANY_OF_INDUSTRY_4
金枫酒业	COMPANY_OF_INDUSTRY_4
沱牌舍得	COMPANY_OF_INDUSTRY_4
水井坊	COMPANY_OF_INDUSTRY_4
山西汾酒	COMPANY_OF_INDUSTRY_4
泸州老窖	COMPANY_OF_INDUSTRY_4
古井贡酒	COMPANY_OF_INDUSTRY_4
燕京啤酒	COMPANY_OF_INDUSTRY_4
西藏发展	COMPANY_OF_INDUSTRY_4
酒鬼酒	COMPANY_OF_INDUSTRY_4
五粮液	COMPANY_OF_INDUSTRY_4
张裕A	COMPANY_OF_INDUSTRY_4
*ST皇台	COMPANY_OF_INDUSTRY_4
洋河股份	COMPANY_OF_INDUSTRY_4
珠江啤酒	COMPANY_OF_INDUSTRY_4
西部创业	COMPANY_OF_INDUSTRY_4
青青稞酒	COMPANY_OF_INDUSTRY_4
今世缘	COMPANY_OF_INDUSTRY_4
会稽山	COMPANY_OF_INDUSTRY_4
迎驾贡酒	COMPANY_OF_INDUSTRY_4
顺鑫农业	COMPANY_OF_INDUSTRY_4
金徽酒	COMPANY_OF_INDUSTRY_4
口子窖	COMPANY_OF_INDUSTRY_4
兰州黄河	COMPANY_OF_INDUSTRY_4
威龙股份	COMPANY_OF_INDUSTRY_4
八菱科技	COMPANY_OF_INDUSTRY_5
天汽模	COMPANY_OF_INDUSTRY_5
中原内配	COMPANY_OF_INDUSTRY_5
松芝股份	COMPANY_OF_INDUSTRY_5
浩物股份	COMPANY_OF_INDUSTRY_5
比亚迪	COMPANY_OF_INDUSTRY_5
豪迈科技	COMPANY_OF_INDUSTRY_5
富奥股份	COMPANY_OF_INDUSTRY_5
东风汽车	COMPANY_OF_INDUSTRY_5
宇通客车	COMPANY_OF_INDUSTRY_5
东风科技	COMPANY_OF_INDUSTRY_5
上汽集团	COMPANY_OF_INDUSTRY_5
长春一东	COMPANY_OF_INDUSTRY_5
福田汽车	COMPANY_OF_INDUSTRY_5
东安动力	COMPANY_OF_INDUSTRY_5
S佳通	COMPANY_OF_INDUSTRY_5
亚星客车	COMPANY_OF_INDUSTRY_5
曙光股份	COMPANY_OF_INDUSTRY_5
江淮汽车	COMPANY_OF_INDUSTRY_5
风神股份	COMPANY_OF_INDUSTRY_5
贵航股份	COMPANY_OF_INDUSTRY_5
金杯汽车	COMPANY_OF_INDUSTRY_5
交运股份	COMPANY_OF_INDUSTRY_5
金龙汽车	COMPANY_OF_INDUSTRY_5
华域汽车	COMPANY_OF_INDUSTRY_5
一汽富维	COMPANY_OF_INDUSTRY_5
*ST黑豹	COMPANY_OF_INDUSTRY_5
特力A	COMPANY_OF_INDUSTRY_5
江铃汽车	COMPANY_OF_INDUSTRY_5
万向钱潮	COMPANY_OF_INDUSTRY_5
海马汽车	COMPANY_OF_INDUSTRY_5
威孚高科	COMPANY_OF_INDUSTRY_5
黔轮胎A	COMPANY_OF_INDUSTRY_5
青岛双星	COMPANY_OF_INDUSTRY_5
长安汽车	COMPANY_OF_INDUSTRY_5
襄阳轴承	COMPANY_OF_INDUSTRY_5
模塑科技	COMPANY_OF_INDUSTRY_5
斯太尔	COMPANY_OF_INDUSTRY_5
一汽轿车	COMPANY_OF_INDUSTRY_5
安凯客车	COMPANY_OF_INDUSTRY_5
一汽夏利	COMPANY_OF_INDUSTRY_5
中国重汽	COMPANY_OF_INDUSTRY_5
中通客车	COMPANY_OF_INDUSTRY_5
金马股份	COMPANY_OF_INDUSTRY_5
巨轮智能	COMPANY_OF_INDUSTRY_5
宁波华翔	COMPANY_OF_INDUSTRY_5
万丰奥威	COMPANY_OF_INDUSTRY_5
广东鸿图	COMPANY_OF_INDUSTRY_5
银轮股份	COMPANY_OF_INDUSTRY_5
成飞集成	COMPANY_OF_INDUSTRY_5
特尔佳	COMPANY_OF_INDUSTRY_5
亚太股份	COMPANY_OF_INDUSTRY_5
兴民钢圈	COMPANY_OF_INDUSTRY_5
隆基机械	COMPANY_OF_INDUSTRY_5
万里扬	COMPANY_OF_INDUSTRY_5
西泵股份	COMPANY_OF_INDUSTRY_5
中国汽研	COMPANY_OF_INDUSTRY_5
德联集团	COMPANY_OF_INDUSTRY_5
浙江世宝	COMPANY_OF_INDUSTRY_5
精锻科技	COMPANY_OF_INDUSTRY_5
悦达投资	COMPANY_OF_INDUSTRY_5
金固股份	COMPANY_OF_INDUSTRY_5
均胜电子	COMPANY_OF_INDUSTRY_5
云意电气	COMPANY_OF_INDUSTRY_5
光洋股份	COMPANY_OF_INDUSTRY_5
鹏翎股份	COMPANY_OF_INDUSTRY_5
双林股份	COMPANY_OF_INDUSTRY_5
广汽集团	COMPANY_OF_INDUSTRY_5
星宇股份	COMPANY_OF_INDUSTRY_5
京威股份	COMPANY_OF_INDUSTRY_5
联明股份	COMPANY_OF_INDUSTRY_5
亚夏汽车	COMPANY_OF_INDUSTRY_5
跃岭股份	COMPANY_OF_INDUSTRY_5
力帆股份	COMPANY_OF_INDUSTRY_5
继峰股份	COMPANY_OF_INDUSTRY_5
长城汽车	COMPANY_OF_INDUSTRY_5
华懋科技	COMPANY_OF_INDUSTRY_5
宁波高发	COMPANY_OF_INDUSTRY_5
福达股份	COMPANY_OF_INDUSTRY_5
腾龙股份	COMPANY_OF_INDUSTRY_5
富临精工	COMPANY_OF_INDUSTRY_5
拓普集团	COMPANY_OF_INDUSTRY_5
龙生股份	COMPANY_OF_INDUSTRY_5
北特科技	COMPANY_OF_INDUSTRY_5
赛轮金宇	COMPANY_OF_INDUSTRY_5
登云股份	COMPANY_OF_INDUSTRY_5
德尔股份	COMPANY_OF_INDUSTRY_5
西部资源	COMPANY_OF_INDUSTRY_5
康普顿	COMPANY_OF_INDUSTRY_5
玲珑轮胎	COMPANY_OF_INDUSTRY_5
广汇汽车	COMPANY_OF_INDUSTRY_5
小康股份	COMPANY_OF_INDUSTRY_5
苏奥传感	COMPANY_OF_INDUSTRY_5
扬子新材	COMPANY_OF_INDUSTRY_5
莲花健康	COMPANY_OF_INDUSTRY_6
华资实业	COMPANY_OF_INDUSTRY_6
安琪酵母	COMPANY_OF_INDUSTRY_6
维维股份	COMPANY_OF_INDUSTRY_6
恒顺醋业	COMPANY_OF_INDUSTRY_6
三元股份	COMPANY_OF_INDUSTRY_6
光明乳业	COMPANY_OF_INDUSTRY_6
绿庭投资	COMPANY_OF_INDUSTRY_6
中粮屯河	COMPANY_OF_INDUSTRY_6
*ST星湖	COMPANY_OF_INDUSTRY_6
伊利股份	COMPANY_OF_INDUSTRY_6
深深宝A	COMPANY_OF_INDUSTRY_6
广弘控股	COMPANY_OF_INDUSTRY_6
黑芝麻	COMPANY_OF_INDUSTRY_6
贵糖股份	COMPANY_OF_INDUSTRY_6
承德露露	COMPANY_OF_INDUSTRY_6
双汇发展	COMPANY_OF_INDUSTRY_6
南宁糖业	COMPANY_OF_INDUSTRY_6
中基健康	COMPANY_OF_INDUSTRY_6
三全食品	COMPANY_OF_INDUSTRY_6
天宝股份	COMPANY_OF_INDUSTRY_6
保龄宝	COMPANY_OF_INDUSTRY_6
皇氏集团	COMPANY_OF_INDUSTRY_6
得利斯	COMPANY_OF_INDUSTRY_6
黑牛食品	COMPANY_OF_INDUSTRY_6
上海梅林	COMPANY_OF_INDUSTRY_6
西王食品	COMPANY_OF_INDUSTRY_6
量子高科	COMPANY_OF_INDUSTRY_6
国投中鲁	COMPANY_OF_INDUSTRY_6
百润股份	COMPANY_OF_INDUSTRY_6
金达威	COMPANY_OF_INDUSTRY_6
克明面业	COMPANY_OF_INDUSTRY_6
贝因美	COMPANY_OF_INDUSTRY_6
汤臣倍健	COMPANY_OF_INDUSTRY_6
加加食品	COMPANY_OF_INDUSTRY_6
煌上煌	COMPANY_OF_INDUSTRY_6
涪陵榨菜	COMPANY_OF_INDUSTRY_6
梅花生物	COMPANY_OF_INDUSTRY_6
凯撒旅游	COMPANY_OF_INDUSTRY_6
海欣食品	COMPANY_OF_INDUSTRY_6
洽洽食品	COMPANY_OF_INDUSTRY_6
金字火腿	COMPANY_OF_INDUSTRY_6
佳隆股份	COMPANY_OF_INDUSTRY_6
麦趣尔	COMPANY_OF_INDUSTRY_6
双塔食品	COMPANY_OF_INDUSTRY_6
燕塘乳业	COMPANY_OF_INDUSTRY_6
海天味业	COMPANY_OF_INDUSTRY_6
爱普股份	COMPANY_OF_INDUSTRY_6
龙力生物	COMPANY_OF_INDUSTRY_6
晨光生物	COMPANY_OF_INDUSTRY_6
千禾味业	COMPANY_OF_INDUSTRY_6
科迪乳业	COMPANY_OF_INDUSTRY_6
众兴菌业	COMPANY_OF_INDUSTRY_6
桃李面包	COMPANY_OF_INDUSTRY_6
安记食品	COMPANY_OF_INDUSTRY_6
天润乳业	COMPANY_OF_INDUSTRY_6
郑州煤电	COMPANY_OF_INDUSTRY_7
兰花科创	COMPANY_OF_INDUSTRY_7
兖州煤业	COMPANY_OF_INDUSTRY_7
阳泉煤业	COMPANY_OF_INDUSTRY_7
盘江股份	COMPANY_OF_INDUSTRY_7
安泰集团	COMPANY_OF_INDUSTRY_7
上海能源	COMPANY_OF_INDUSTRY_7
*ST山煤	COMPANY_OF_INDUSTRY_7
山西焦化	COMPANY_OF_INDUSTRY_7
恒源煤电	COMPANY_OF_INDUSTRY_7
开滦股份	COMPANY_OF_INDUSTRY_7
大同煤业	COMPANY_OF_INDUSTRY_7
中国神华	COMPANY_OF_INDUSTRY_7
昊华能源	COMPANY_OF_INDUSTRY_7
平煤股份	COMPANY_OF_INDUSTRY_7
潞安环能	COMPANY_OF_INDUSTRY_7
中煤能源	COMPANY_OF_INDUSTRY_7
*ST新集	COMPANY_OF_INDUSTRY_7
靖远煤电	COMPANY_OF_INDUSTRY_7
美锦能源	COMPANY_OF_INDUSTRY_7
平庄能源	COMPANY_OF_INDUSTRY_7
*ST神火	COMPANY_OF_INDUSTRY_7
冀中能源	COMPANY_OF_INDUSTRY_7
*ST煤气	COMPANY_OF_INDUSTRY_7
西山煤电	COMPANY_OF_INDUSTRY_7
露天煤业	COMPANY_OF_INDUSTRY_7
新大洲A	COMPANY_OF_INDUSTRY_7
金瑞矿业	COMPANY_OF_INDUSTRY_7
安源煤业	COMPANY_OF_INDUSTRY_7
大有能源	COMPANY_OF_INDUSTRY_7
*ST百花	COMPANY_OF_INDUSTRY_7
宝泰隆	COMPANY_OF_INDUSTRY_7
云煤能源	COMPANY_OF_INDUSTRY_7
永泰能源	COMPANY_OF_INDUSTRY_7
陕西煤业	COMPANY_OF_INDUSTRY_7
陕西黑猫	COMPANY_OF_INDUSTRY_7
瑞茂通	COMPANY_OF_INDUSTRY_7
永东股份	COMPANY_OF_INDUSTRY_7
红阳能源	COMPANY_OF_INDUSTRY_7
春兰股份	COMPANY_OF_INDUSTRY_8
老板电器	COMPANY_OF_INDUSTRY_8
长青集团	COMPANY_OF_INDUSTRY_8
圣莱达	COMPANY_OF_INDUSTRY_8
蒙发利	COMPANY_OF_INDUSTRY_8
海信电器	COMPANY_OF_INDUSTRY_8
澳柯玛	COMPANY_OF_INDUSTRY_8
XD青岛海	COMPANY_OF_INDUSTRY_8
四川长虹	COMPANY_OF_INDUSTRY_8
厦华电子	COMPANY_OF_INDUSTRY_8
惠而浦	COMPANY_OF_INDUSTRY_8
深康佳A	COMPANY_OF_INDUSTRY_8
TCL集团	COMPANY_OF_INDUSTRY_8
小天鹅A	COMPANY_OF_INDUSTRY_8
美菱电器	COMPANY_OF_INDUSTRY_8
万家乐	COMPANY_OF_INDUSTRY_8
格力电器	COMPANY_OF_INDUSTRY_8
四川九洲	COMPANY_OF_INDUSTRY_8
海信科龙	COMPANY_OF_INDUSTRY_8
德豪润达	COMPANY_OF_INDUSTRY_8
苏泊尔	COMPANY_OF_INDUSTRY_8
华帝股份	COMPANY_OF_INDUSTRY_8
九阳股份	COMPANY_OF_INDUSTRY_8
德奥通航	COMPANY_OF_INDUSTRY_8
爱仕达	COMPANY_OF_INDUSTRY_8
兆驰股份	COMPANY_OF_INDUSTRY_8
日出东方	COMPANY_OF_INDUSTRY_8
浙江美大	COMPANY_OF_INDUSTRY_8
万和电气	COMPANY_OF_INDUSTRY_8
亿利达	COMPANY_OF_INDUSTRY_8
天银机电	COMPANY_OF_INDUSTRY_8
金莱特	COMPANY_OF_INDUSTRY_8
新宝股份	COMPANY_OF_INDUSTRY_8
奋达科技	COMPANY_OF_INDUSTRY_8
银河电子	COMPANY_OF_INDUSTRY_8
奥马电器	COMPANY_OF_INDUSTRY_8
美的集团	COMPANY_OF_INDUSTRY_8
莱克电气	COMPANY_OF_INDUSTRY_8
天际股份	COMPANY_OF_INDUSTRY_8
聚隆科技	COMPANY_OF_INDUSTRY_8
飞科电器	COMPANY_OF_INDUSTRY_8
朗迪集团	COMPANY_OF_INDUSTRY_8
三花股份	COMPANY_OF_INDUSTRY_8
东凌国际	COMPANY_OF_INDUSTRY_9
*ST金源	COMPANY_OF_INDUSTRY_9
史丹利	COMPANY_OF_INDUSTRY_9
新洋丰	COMPANY_OF_INDUSTRY_9
金正大	COMPANY_OF_INDUSTRY_9
红太阳	COMPANY_OF_INDUSTRY_9
河池化工	COMPANY_OF_INDUSTRY_9
新都化工	COMPANY_OF_INDUSTRY_9
芭田股份	COMPANY_OF_INDUSTRY_9
华鲁恒升	COMPANY_OF_INDUSTRY_9
云天化	COMPANY_OF_INDUSTRY_9
华昌化工	COMPANY_OF_INDUSTRY_9
司尔特	COMPANY_OF_INDUSTRY_9
六国化工	COMPANY_OF_INDUSTRY_9
鲁北化工	COMPANY_OF_INDUSTRY_9
四川美丰	COMPANY_OF_INDUSTRY_9
*ST建峰	COMPANY_OF_INDUSTRY_9
湖北宜化	COMPANY_OF_INDUSTRY_9
柳化股份	COMPANY_OF_INDUSTRY_9
泸天化	COMPANY_OF_INDUSTRY_9
澄星股份	COMPANY_OF_INDUSTRY_9
鲁西化工	COMPANY_OF_INDUSTRY_9
阳煤化工	COMPANY_OF_INDUSTRY_9
盛屯矿业	COMPANY_OF_INDUSTRY_10
兴业矿业	COMPANY_OF_INDUSTRY_10
XR怡球资	COMPANY_OF_INDUSTRY_10
海亮股份	COMPANY_OF_INDUSTRY_10
精艺股份	COMPANY_OF_INDUSTRY_10
新疆众和	COMPANY_OF_INDUSTRY_10
明泰铝业	COMPANY_OF_INDUSTRY_10
北方稀土	COMPANY_OF_INDUSTRY_10
南山铝业	COMPANY_OF_INDUSTRY_10
广晟有色	COMPANY_OF_INDUSTRY_10
宏达股份	COMPANY_OF_INDUSTRY_10
西藏珠峰	COMPANY_OF_INDUSTRY_10
宝钛股份	COMPANY_OF_INDUSTRY_10
贵研铂业	COMPANY_OF_INDUSTRY_10
驰宏锌锗	COMPANY_OF_INDUSTRY_10
豫光金铅	COMPANY_OF_INDUSTRY_10
厦门钨业	COMPANY_OF_INDUSTRY_10
中孚实业	COMPANY_OF_INDUSTRY_10
东阳光科	COMPANY_OF_INDUSTRY_10
株冶集团	COMPANY_OF_INDUSTRY_10
西部矿业	COMPANY_OF_INDUSTRY_10
中国铝业	COMPANY_OF_INDUSTRY_10
金钼股份	COMPANY_OF_INDUSTRY_10
中金岭南	COMPANY_OF_INDUSTRY_10
焦作万方	COMPANY_OF_INDUSTRY_10
铜陵有色	COMPANY_OF_INDUSTRY_10
中钨高新	COMPANY_OF_INDUSTRY_10
锌业股份	COMPANY_OF_INDUSTRY_10
中色股份	COMPANY_OF_INDUSTRY_10
西藏矿业	COMPANY_OF_INDUSTRY_10
云铝股份	COMPANY_OF_INDUSTRY_10
*ST五稀	COMPANY_OF_INDUSTRY_10
云南铜业	COMPANY_OF_INDUSTRY_10
锡业股份	COMPANY_OF_INDUSTRY_10
*ST东钽	COMPANY_OF_INDUSTRY_10
罗平锌电	COMPANY_OF_INDUSTRY_10
常铝股份	COMPANY_OF_INDUSTRY_10
东方锆业	COMPANY_OF_INDUSTRY_10
楚江新材	COMPANY_OF_INDUSTRY_10
云海金属	COMPANY_OF_INDUSTRY_10
章源钨业	COMPANY_OF_INDUSTRY_10
云南锗业	COMPANY_OF_INDUSTRY_10
江西铜业	COMPANY_OF_INDUSTRY_10
*ST吉恩	COMPANY_OF_INDUSTRY_10
鑫科材料	COMPANY_OF_INDUSTRY_10
创兴资源	COMPANY_OF_INDUSTRY_10
建新矿业	COMPANY_OF_INDUSTRY_10
炼石有色	COMPANY_OF_INDUSTRY_10
博威合金	COMPANY_OF_INDUSTRY_10
新华龙	COMPANY_OF_INDUSTRY_10
亚太科技	COMPANY_OF_INDUSTRY_10
威华股份	COMPANY_OF_INDUSTRY_10
赣锋锂业	COMPANY_OF_INDUSTRY_10
银泰资源	COMPANY_OF_INDUSTRY_10
宁波韵升	COMPANY_OF_INDUSTRY_10
盛达矿业	COMPANY_OF_INDUSTRY_10
科恒股份	COMPANY_OF_INDUSTRY_10
利源精制	COMPANY_OF_INDUSTRY_10
华友钴业	COMPANY_OF_INDUSTRY_10
闽发铝业	COMPANY_OF_INDUSTRY_10
洛阳钼业	COMPANY_OF_INDUSTRY_10
四通新材	COMPANY_OF_INDUSTRY_10
ST华泽	COMPANY_OF_INDUSTRY_10
盛和资源	COMPANY_OF_INDUSTRY_10
华钰矿业	COMPANY_OF_INDUSTRY_10
鹏欣资源	COMPANY_OF_INDUSTRY_10
*ST合金	COMPANY_OF_INDUSTRY_10
宏达矿业	COMPANY_OF_INDUSTRY_10
*ST兴业	COMPANY_OF_INDUSTRY_10
鼎立股份	COMPANY_OF_INDUSTRY_10
银鸽投资	COMPANY_OF_INDUSTRY_11
青山纸业	COMPANY_OF_INDUSTRY_11
民丰特纸	COMPANY_OF_INDUSTRY_11
华泰股份	COMPANY_OF_INDUSTRY_11
恒丰纸业	COMPANY_OF_INDUSTRY_11
冠豪高新	COMPANY_OF_INDUSTRY_11
山鹰纸业	COMPANY_OF_INDUSTRY_11
ST宜纸	COMPANY_OF_INDUSTRY_11
岳阳林纸	COMPANY_OF_INDUSTRY_11
博汇纸业	COMPANY_OF_INDUSTRY_11
晨鸣纸业	COMPANY_OF_INDUSTRY_11
美利纸业	COMPANY_OF_INDUSTRY_11
金城股份	COMPANY_OF_INDUSTRY_11
凯恩股份	COMPANY_OF_INDUSTRY_11
景兴纸业	COMPANY_OF_INDUSTRY_11
太阳纸业	COMPANY_OF_INDUSTRY_11
安妮股份	COMPANY_OF_INDUSTRY_11
中顺洁柔	COMPANY_OF_INDUSTRY_11
齐峰新材	COMPANY_OF_INDUSTRY_11
吉宏股份	COMPANY_OF_INDUSTRY_11
广东甘化	COMPANY_OF_INDUSTRY_11
环球印务	COMPANY_OF_INDUSTRY_11
尔康制药	COMPANY_OF_INDUSTRY_12
泰格医药	COMPANY_OF_INDUSTRY_12
济川药业	COMPANY_OF_INDUSTRY_12
誉衡药业	COMPANY_OF_INDUSTRY_12
国农科技	COMPANY_OF_INDUSTRY_12
瑞康医药	COMPANY_OF_INDUSTRY_12
佛慈制药	COMPANY_OF_INDUSTRY_12
金城医药	COMPANY_OF_INDUSTRY_12
东宝生物	COMPANY_OF_INDUSTRY_12
东诚药业	COMPANY_OF_INDUSTRY_12
中国医药	COMPANY_OF_INDUSTRY_12
华润双鹤	COMPANY_OF_INDUSTRY_12
人福医药	COMPANY_OF_INDUSTRY_12
金花股份	COMPANY_OF_INDUSTRY_12
同仁堂	COMPANY_OF_INDUSTRY_12
太极集团	COMPANY_OF_INDUSTRY_12
天坛生物	COMPANY_OF_INDUSTRY_12
复星医药	COMPANY_OF_INDUSTRY_12
西藏药业	COMPANY_OF_INDUSTRY_12
浙江医药	COMPANY_OF_INDUSTRY_12
太龙药业	COMPANY_OF_INDUSTRY_12
海正药业	COMPANY_OF_INDUSTRY_12
恒瑞医药	COMPANY_OF_INDUSTRY_12
羚锐制药	COMPANY_OF_INDUSTRY_12
中新药业	COMPANY_OF_INDUSTRY_12
白云山	COMPANY_OF_INDUSTRY_12
亚宝药业	COMPANY_OF_INDUSTRY_12
健康元	COMPANY_OF_INDUSTRY_12
现代制药	COMPANY_OF_INDUSTRY_12
仰帆控股	COMPANY_OF_INDUSTRY_12
昆药集团	COMPANY_OF_INDUSTRY_12
片仔癀	COMPANY_OF_INDUSTRY_12
千金药业	COMPANY_OF_INDUSTRY_12
天药股份	COMPANY_OF_INDUSTRY_12
国药股份	COMPANY_OF_INDUSTRY_12
联环药业	COMPANY_OF_INDUSTRY_12
康美药业	COMPANY_OF_INDUSTRY_12
华海药业	COMPANY_OF_INDUSTRY_12
交大昂立	COMPANY_OF_INDUSTRY_12
天士力	COMPANY_OF_INDUSTRY_12
康缘药业	COMPANY_OF_INDUSTRY_12
中珠医疗	COMPANY_OF_INDUSTRY_12
康恩贝	COMPANY_OF_INDUSTRY_12
益佰制药	COMPANY_OF_INDUSTRY_12
神奇制药	COMPANY_OF_INDUSTRY_12
中源协和	COMPANY_OF_INDUSTRY_12
哈药股份	COMPANY_OF_INDUSTRY_12
奥瑞德	COMPANY_OF_INDUSTRY_12
天目药业	COMPANY_OF_INDUSTRY_12
XD南京医	COMPANY_OF_INDUSTRY_12
江中药业	COMPANY_OF_INDUSTRY_12
通策医疗	COMPANY_OF_INDUSTRY_12
广誉远	COMPANY_OF_INDUSTRY_12
辅仁药业	COMPANY_OF_INDUSTRY_12
鲁抗医药	COMPANY_OF_INDUSTRY_12
华北制药	COMPANY_OF_INDUSTRY_12
人民同泰	COMPANY_OF_INDUSTRY_12
第一医药	COMPANY_OF_INDUSTRY_12
通化东宝	COMPANY_OF_INDUSTRY_12
健民集团	COMPANY_OF_INDUSTRY_12
马应龙	COMPANY_OF_INDUSTRY_12
上海医药	COMPANY_OF_INDUSTRY_12
国药一致	COMPANY_OF_INDUSTRY_12
海王生物	COMPANY_OF_INDUSTRY_12
丰原药业	COMPANY_OF_INDUSTRY_12
英特集团	COMPANY_OF_INDUSTRY_12
东阿阿胶	COMPANY_OF_INDUSTRY_12
丽珠集团	COMPANY_OF_INDUSTRY_12
四环生物	COMPANY_OF_INDUSTRY_12
云南白药	COMPANY_OF_INDUSTRY_12
海南海药	COMPANY_OF_INDUSTRY_12
东北制药	COMPANY_OF_INDUSTRY_12
*ST易桥	COMPANY_OF_INDUSTRY_12
吉林敖东	COMPANY_OF_INDUSTRY_12
仁和药业	COMPANY_OF_INDUSTRY_12
长春高新	COMPANY_OF_INDUSTRY_12
浙江震元	COMPANY_OF_INDUSTRY_12
普洛药业	COMPANY_OF_INDUSTRY_12
新华制药	COMPANY_OF_INDUSTRY_12
通化金马	COMPANY_OF_INDUSTRY_12
北大医药	COMPANY_OF_INDUSTRY_12
金陵药业	COMPANY_OF_INDUSTRY_12
广济药业	COMPANY_OF_INDUSTRY_12
华东医药	COMPANY_OF_INDUSTRY_12
九芝堂	COMPANY_OF_INDUSTRY_12
华润三九	COMPANY_OF_INDUSTRY_12
新和成	COMPANY_OF_INDUSTRY_12
华兰生物	COMPANY_OF_INDUSTRY_12
亿帆鑫富	COMPANY_OF_INDUSTRY_12
京新药业	COMPANY_OF_INDUSTRY_12
科华生物	COMPANY_OF_INDUSTRY_12
达安基因	COMPANY_OF_INDUSTRY_12
双鹭药业	COMPANY_OF_INDUSTRY_12
海翔药业	COMPANY_OF_INDUSTRY_12
沃华医药	COMPANY_OF_INDUSTRY_12
紫鑫药业	COMPANY_OF_INDUSTRY_12
莱茵生物	COMPANY_OF_INDUSTRY_12
嘉应制药	COMPANY_OF_INDUSTRY_12
恒康医疗	COMPANY_OF_INDUSTRY_12
上海莱士	COMPANY_OF_INDUSTRY_12
恩华药业	COMPANY_OF_INDUSTRY_12
桂林三金	COMPANY_OF_INDUSTRY_12
奇正藏药	COMPANY_OF_INDUSTRY_12
信立泰	COMPANY_OF_INDUSTRY_12
众生药业	COMPANY_OF_INDUSTRY_12
精华制药	COMPANY_OF_INDUSTRY_12
永安药业	COMPANY_OF_INDUSTRY_12
亚太药业	COMPANY_OF_INDUSTRY_12
信邦制药	COMPANY_OF_INDUSTRY_12
力生制药	COMPANY_OF_INDUSTRY_12
海普瑞	COMPANY_OF_INDUSTRY_12
汉森制药	COMPANY_OF_INDUSTRY_12
科伦药业	COMPANY_OF_INDUSTRY_12
贵州百灵	COMPANY_OF_INDUSTRY_12
太安堂	COMPANY_OF_INDUSTRY_12
莱美药业	COMPANY_OF_INDUSTRY_12
安科生物	COMPANY_OF_INDUSTRY_12
爱尔眼科	COMPANY_OF_INDUSTRY_12
北陆药业	COMPANY_OF_INDUSTRY_12
红日药业	COMPANY_OF_INDUSTRY_12
上海凯宝	COMPANY_OF_INDUSTRY_12
福瑞股份	COMPANY_OF_INDUSTRY_12
康芝药业	COMPANY_OF_INDUSTRY_12
启迪古汉	COMPANY_OF_INDUSTRY_12
福安药业	COMPANY_OF_INDUSTRY_12
海思科	COMPANY_OF_INDUSTRY_12
佐力药业	COMPANY_OF_INDUSTRY_12
益盛药业	COMPANY_OF_INDUSTRY_12
智飞生物	COMPANY_OF_INDUSTRY_12
利德曼	COMPANY_OF_INDUSTRY_12
博雅生物	COMPANY_OF_INDUSTRY_12
嘉事堂	COMPANY_OF_INDUSTRY_12
华仁药业	COMPANY_OF_INDUSTRY_12
九州通	COMPANY_OF_INDUSTRY_12
沃森生物	COMPANY_OF_INDUSTRY_12
舒泰神	COMPANY_OF_INDUSTRY_12
奥赛康	COMPANY_OF_INDUSTRY_12
双成药业	COMPANY_OF_INDUSTRY_12
ST生化	COMPANY_OF_INDUSTRY_12
我武生物	COMPANY_OF_INDUSTRY_12
博腾股份	COMPANY_OF_INDUSTRY_12
香雪制药	COMPANY_OF_INDUSTRY_12
迪安诊断	COMPANY_OF_INDUSTRY_12
以岭药业	COMPANY_OF_INDUSTRY_12
仟源医药	COMPANY_OF_INDUSTRY_12
常山药业	COMPANY_OF_INDUSTRY_12
山大华特	COMPANY_OF_INDUSTRY_12
莎普爱思	COMPANY_OF_INDUSTRY_12
广生堂	COMPANY_OF_INDUSTRY_12
翰宇药业	COMPANY_OF_INDUSTRY_12
济民制药	COMPANY_OF_INDUSTRY_12
方盛制药	COMPANY_OF_INDUSTRY_12
柳州医药	COMPANY_OF_INDUSTRY_12
瑞普生物	COMPANY_OF_INDUSTRY_12
慈铭体检	COMPANY_OF_INDUSTRY_12
九强生物	COMPANY_OF_INDUSTRY_12
振东制药	COMPANY_OF_INDUSTRY_12
中牧股份	COMPANY_OF_INDUSTRY_12
益丰药房	COMPANY_OF_INDUSTRY_12
花园生物	COMPANY_OF_INDUSTRY_12
九洲药业	COMPANY_OF_INDUSTRY_12
龙津药业	COMPANY_OF_INDUSTRY_12
一心堂	COMPANY_OF_INDUSTRY_12
中恒集团	COMPANY_OF_INDUSTRY_12
珍宝岛	COMPANY_OF_INDUSTRY_12
博济医药	COMPANY_OF_INDUSTRY_12
未名医药	COMPANY_OF_INDUSTRY_12
葵花药业	COMPANY_OF_INDUSTRY_12
台城制药	COMPANY_OF_INDUSTRY_12
普莱柯	COMPANY_OF_INDUSTRY_12
海利生物	COMPANY_OF_INDUSTRY_12
山河药辅	COMPANY_OF_INDUSTRY_12
润达医疗	COMPANY_OF_INDUSTRY_12
华通医药	COMPANY_OF_INDUSTRY_12
灵康药业	COMPANY_OF_INDUSTRY_12
ST春天	COMPANY_OF_INDUSTRY_12
司太立	COMPANY_OF_INDUSTRY_12
万孚生物	COMPANY_OF_INDUSTRY_12
赛升药业	COMPANY_OF_INDUSTRY_12
康弘药业	COMPANY_OF_INDUSTRY_12
富祥股份	COMPANY_OF_INDUSTRY_12
冠福股份	COMPANY_OF_INDUSTRY_12
新光药业	COMPANY_OF_INDUSTRY_12
景峰医药	COMPANY_OF_INDUSTRY_12
华神集团	COMPANY_OF_INDUSTRY_12
长生生物	COMPANY_OF_INDUSTRY_12
江苏吴中	COMPANY_OF_INDUSTRY_12
明牌珠宝	COMPANY_OF_INDUSTRY_14
金一文化	COMPANY_OF_INDUSTRY_14
飞亚达A	COMPANY_OF_INDUSTRY_14
老凤祥	COMPANY_OF_INDUSTRY_14
爱迪尔	COMPANY_OF_INDUSTRY_14
潮宏基	COMPANY_OF_INDUSTRY_14
萃华珠宝	COMPANY_OF_INDUSTRY_14
东方金钰	COMPANY_OF_INDUSTRY_14
金洲慈航	COMPANY_OF_INDUSTRY_14
思创医惠	COMPANY_OF_INDUSTRY_15
汉邦高科	COMPANY_OF_INDUSTRY_15
大华股份	COMPANY_OF_INDUSTRY_15
天夏智慧	COMPANY_OF_INDUSTRY_15
东方网力	COMPANY_OF_INDUSTRY_15
海康威视	COMPANY_OF_INDUSTRY_15
高德红外	COMPANY_OF_INDUSTRY_15
GQY视讯	COMPANY_OF_INDUSTRY_15
保千里	COMPANY_OF_INDUSTRY_15
海能达	COMPANY_OF_INDUSTRY_15
高新兴	COMPANY_OF_INDUSTRY_15
大立科技	COMPANY_OF_INDUSTRY_15
迪威视讯	COMPANY_OF_INDUSTRY_15
中威电子	COMPANY_OF_INDUSTRY_15
中电鑫龙	COMPANY_OF_INDUSTRY_15
林州重机	COMPANY_OF_INDUSTRY_15
拓邦股份	COMPANY_OF_INDUSTRY_15
航天长峰	COMPANY_OF_INDUSTRY_15
新大陆	COMPANY_OF_INDUSTRY_15
英飞拓	COMPANY_OF_INDUSTRY_15
同方股份	COMPANY_OF_INDUSTRY_15
道明光学	COMPANY_OF_INDUSTRY_15
欧比特	COMPANY_OF_INDUSTRY_15
安居宝	COMPANY_OF_INDUSTRY_15
鑫茂科技	COMPANY_OF_INDUSTRY_15
喜临门	COMPANY_OF_INDUSTRY_16
浙江永强	COMPANY_OF_INDUSTRY_16
吉林森工	COMPANY_OF_INDUSTRY_16
*ST景谷	COMPANY_OF_INDUSTRY_16
美克家居	COMPANY_OF_INDUSTRY_16
宜华生活	COMPANY_OF_INDUSTRY_16
平潭发展	COMPANY_OF_INDUSTRY_16
永安林业	COMPANY_OF_INDUSTRY_16
大亚科技	COMPANY_OF_INDUSTRY_16
兔宝宝	COMPANY_OF_INDUSTRY_16
升达林业	COMPANY_OF_INDUSTRY_16
索菲亚	COMPANY_OF_INDUSTRY_16
福建金森	COMPANY_OF_INDUSTRY_16
易尚展示	COMPANY_OF_INDUSTRY_16
友邦吊顶	COMPANY_OF_INDUSTRY_16
永艺股份	COMPANY_OF_INDUSTRY_16
好莱客	COMPANY_OF_INDUSTRY_16
德尔未来	COMPANY_OF_INDUSTRY_16
丰林集团	COMPANY_OF_INDUSTRY_16
曲美家居	COMPANY_OF_INDUSTRY_16
文科园林	COMPANY_OF_INDUSTRY_16
沃施股份	COMPANY_OF_INDUSTRY_16
帝王洁具	COMPANY_OF_INDUSTRY_16
康欣新材	COMPANY_OF_INDUSTRY_16
首创股份	COMPANY_OF_INDUSTRY_17
武汉控股	COMPANY_OF_INDUSTRY_17
国中水务	COMPANY_OF_INDUSTRY_17
钱江水利	COMPANY_OF_INDUSTRY_17
瀚蓝环境	COMPANY_OF_INDUSTRY_17
长春燃气	COMPANY_OF_INDUSTRY_17
洪城水业	COMPANY_OF_INDUSTRY_17
大众公用	COMPANY_OF_INDUSTRY_17
哈投股份	COMPANY_OF_INDUSTRY_17
创业环保	COMPANY_OF_INDUSTRY_17
广安爱众	COMPANY_OF_INDUSTRY_17
深圳燃气	COMPANY_OF_INDUSTRY_17
重庆水务	COMPANY_OF_INDUSTRY_17
深圳能源	COMPANY_OF_INDUSTRY_17
中原环保	COMPANY_OF_INDUSTRY_17
大通燃气	COMPANY_OF_INDUSTRY_17
中山公用	COMPANY_OF_INDUSTRY_17
惠天热电	COMPANY_OF_INDUSTRY_17
兴蓉环境	COMPANY_OF_INDUSTRY_17
江南水务	COMPANY_OF_INDUSTRY_17
新疆浩源	COMPANY_OF_INDUSTRY_17
清水源	COMPANY_OF_INDUSTRY_17
重庆燃气	COMPANY_OF_INDUSTRY_17
渤海股份	COMPANY_OF_INDUSTRY_17
国祯环保	COMPANY_OF_INDUSTRY_17
绿城水务	COMPANY_OF_INDUSTRY_17
百川能源	COMPANY_OF_INDUSTRY_17
慧球科技	COMPANY_OF_INDUSTRY_17
南京公用	COMPANY_OF_INDUSTRY_17
国新能源	COMPANY_OF_INDUSTRY_17
中信证券	COMPANY_OF_INDUSTRY_18
国金证券	COMPANY_OF_INDUSTRY_18
西南证券	COMPANY_OF_INDUSTRY_18
海通证券	COMPANY_OF_INDUSTRY_18
招商证券	COMPANY_OF_INDUSTRY_18
太平洋	COMPANY_OF_INDUSTRY_18
华泰证券	COMPANY_OF_INDUSTRY_18
光大证券	COMPANY_OF_INDUSTRY_18
东北证券	COMPANY_OF_INDUSTRY_18
国元证券	COMPANY_OF_INDUSTRY_18
广发证券	COMPANY_OF_INDUSTRY_18
长江证券	COMPANY_OF_INDUSTRY_18
方正证券	COMPANY_OF_INDUSTRY_18
兴业证券	COMPANY_OF_INDUSTRY_18
山西证券	COMPANY_OF_INDUSTRY_18
东吴证券	COMPANY_OF_INDUSTRY_18
西部证券	COMPANY_OF_INDUSTRY_18
国海证券	COMPANY_OF_INDUSTRY_18
申万宏源	COMPANY_OF_INDUSTRY_18
东兴证券	COMPANY_OF_INDUSTRY_18
东方证券	COMPANY_OF_INDUSTRY_18
国信证券	COMPANY_OF_INDUSTRY_18
国泰君安	COMPANY_OF_INDUSTRY_18
安信信托	COMPANY_OF_INDUSTRY_18
第一创业	COMPANY_OF_INDUSTRY_18
国投安信	COMPANY_OF_INDUSTRY_18
华声股份	COMPANY_OF_INDUSTRY_18
江南高纤	COMPANY_OF_INDUSTRY_19
神马股份	COMPANY_OF_INDUSTRY_19
南京化纤	COMPANY_OF_INDUSTRY_19
吉林化纤	COMPANY_OF_INDUSTRY_19
友利控股	COMPANY_OF_INDUSTRY_19
恒天海龙	COMPANY_OF_INDUSTRY_19
美达股份	COMPANY_OF_INDUSTRY_19
华西股份	COMPANY_OF_INDUSTRY_19
新乡化纤	COMPANY_OF_INDUSTRY_19
欣龙控股	COMPANY_OF_INDUSTRY_19
春晖股份	COMPANY_OF_INDUSTRY_19
华孚色纺	COMPANY_OF_INDUSTRY_19
华峰氨纶	COMPANY_OF_INDUSTRY_19
浔兴股份	COMPANY_OF_INDUSTRY_19
澳洋科技	COMPANY_OF_INDUSTRY_19
海利得	COMPANY_OF_INDUSTRY_19
泰和新材	COMPANY_OF_INDUSTRY_19
尤夫股份	COMPANY_OF_INDUSTRY_19
荣盛石化	COMPANY_OF_INDUSTRY_19
华鼎股份	COMPANY_OF_INDUSTRY_19
三联虹普	COMPANY_OF_INDUSTRY_19
桐昆股份	COMPANY_OF_INDUSTRY_19
智度投资	COMPANY_OF_INDUSTRY_20
天兴仪表	COMPANY_OF_INDUSTRY_20
威尔泰	COMPANY_OF_INDUSTRY_20
东方网络	COMPANY_OF_INDUSTRY_20
奥普光电	COMPANY_OF_INDUSTRY_20
赫美集团	COMPANY_OF_INDUSTRY_20
汉威电子	COMPANY_OF_INDUSTRY_20
华测检测	COMPANY_OF_INDUSTRY_20
三川智慧	COMPANY_OF_INDUSTRY_20
东华测试	COMPANY_OF_INDUSTRY_20
天瑞仪器	COMPANY_OF_INDUSTRY_20
梅安森	COMPANY_OF_INDUSTRY_20
美亚光电	COMPANY_OF_INDUSTRY_20
新天科技	COMPANY_OF_INDUSTRY_20
安科瑞	COMPANY_OF_INDUSTRY_20
远方光电	COMPANY_OF_INDUSTRY_20
金卡股份	COMPANY_OF_INDUSTRY_20
万讯自控	COMPANY_OF_INDUSTRY_20
雪迪龙	COMPANY_OF_INDUSTRY_20
汇川技术	COMPANY_OF_INDUSTRY_20
聚光科技	COMPANY_OF_INDUSTRY_20
炬华科技	COMPANY_OF_INDUSTRY_20
尤洛卡	COMPANY_OF_INDUSTRY_20
三星医疗	COMPANY_OF_INDUSTRY_20
开元仪器	COMPANY_OF_INDUSTRY_20
凯发电气	COMPANY_OF_INDUSTRY_20
林洋能源	COMPANY_OF_INDUSTRY_20
吉艾科技	COMPANY_OF_INDUSTRY_20
南华仪器	COMPANY_OF_INDUSTRY_20
汇中股份	COMPANY_OF_INDUSTRY_20
安控科技	COMPANY_OF_INDUSTRY_20
弘讯科技	COMPANY_OF_INDUSTRY_20
兰石重装	COMPANY_OF_INDUSTRY_20
川仪股份	COMPANY_OF_INDUSTRY_20
康斯特	COMPANY_OF_INDUSTRY_20
威帝股份	COMPANY_OF_INDUSTRY_20
先锋电子	COMPANY_OF_INDUSTRY_20
中元股份	COMPANY_OF_INDUSTRY_20
赛摩电气	COMPANY_OF_INDUSTRY_20
三德科技	COMPANY_OF_INDUSTRY_20
中船防务	COMPANY_OF_INDUSTRY_21
中国船舶	COMPANY_OF_INDUSTRY_21
钢构工程	COMPANY_OF_INDUSTRY_21
天海防务	COMPANY_OF_INDUSTRY_21
宝鼎科技	COMPANY_OF_INDUSTRY_21
太阳鸟	COMPANY_OF_INDUSTRY_21
潍柴重机	COMPANY_OF_INDUSTRY_21
亚星锚链	COMPANY_OF_INDUSTRY_21
中国重工	COMPANY_OF_INDUSTRY_21
*ST舜船	COMPANY_OF_INDUSTRY_21
柘中股份	COMPANY_OF_INDUSTRY_22
伟星新材	COMPANY_OF_INDUSTRY_22
国栋建设	COMPANY_OF_INDUSTRY_22
青松建化	COMPANY_OF_INDUSTRY_22
宁夏建材	COMPANY_OF_INDUSTRY_22
杭萧钢构	COMPANY_OF_INDUSTRY_22
ST狮头	COMPANY_OF_INDUSTRY_22
海螺水泥	COMPANY_OF_INDUSTRY_22
尖峰集团	COMPANY_OF_INDUSTRY_22
四川金顶	COMPANY_OF_INDUSTRY_22
祁连山	COMPANY_OF_INDUSTRY_22
华新水泥	COMPANY_OF_INDUSTRY_22
福建水泥	COMPANY_OF_INDUSTRY_22
亚泰集团	COMPANY_OF_INDUSTRY_22
博闻科技	COMPANY_OF_INDUSTRY_22
中材国际	COMPANY_OF_INDUSTRY_22
深天地A	COMPANY_OF_INDUSTRY_22
冀东水泥	COMPANY_OF_INDUSTRY_22
海螺型材	COMPANY_OF_INDUSTRY_22
北新建材	COMPANY_OF_INDUSTRY_22
万年青	COMPANY_OF_INDUSTRY_22
天山股份	COMPANY_OF_INDUSTRY_22
同力水泥	COMPANY_OF_INDUSTRY_22
四川双马	COMPANY_OF_INDUSTRY_22
栋梁新材	COMPANY_OF_INDUSTRY_22
海鸥卫浴	COMPANY_OF_INDUSTRY_22
融捷股份	COMPANY_OF_INDUSTRY_22
塔牌集团	COMPANY_OF_INDUSTRY_22
帝龙新材	COMPANY_OF_INDUSTRY_22
东方雨虹	COMPANY_OF_INDUSTRY_22
西部建设	COMPANY_OF_INDUSTRY_22
南山控股	COMPANY_OF_INDUSTRY_22
罗普斯金	COMPANY_OF_INDUSTRY_22
上峰水泥	COMPANY_OF_INDUSTRY_22
东方铁塔	COMPANY_OF_INDUSTRY_22
精工钢构	COMPANY_OF_INDUSTRY_22
光正集团	COMPANY_OF_INDUSTRY_22
金隅股份	COMPANY_OF_INDUSTRY_22
青龙管业	COMPANY_OF_INDUSTRY_22
国统股份	COMPANY_OF_INDUSTRY_22
巨龙管业	COMPANY_OF_INDUSTRY_22
鸿路钢构	COMPANY_OF_INDUSTRY_22
海南瑞泽	COMPANY_OF_INDUSTRY_22
龙泉股份	COMPANY_OF_INDUSTRY_22
嘉寓股份	COMPANY_OF_INDUSTRY_22
纳川股份	COMPANY_OF_INDUSTRY_22
三圣特材	COMPANY_OF_INDUSTRY_22
富煌钢构	COMPANY_OF_INDUSTRY_22
韩建河山	COMPANY_OF_INDUSTRY_22
万里石	COMPANY_OF_INDUSTRY_22
金圆股份	COMPANY_OF_INDUSTRY_22
华塑控股	COMPANY_OF_INDUSTRY_22
中技控股	COMPANY_OF_INDUSTRY_22
*ST天首	COMPANY_OF_INDUSTRY_23
搜于特	COMPANY_OF_INDUSTRY_23
森马服饰	COMPANY_OF_INDUSTRY_23
兴业科技	COMPANY_OF_INDUSTRY_23
浙江富润	COMPANY_OF_INDUSTRY_23
美尔雅	COMPANY_OF_INDUSTRY_23
浪莎股份	COMPANY_OF_INDUSTRY_23
维科精华	COMPANY_OF_INDUSTRY_23
雅戈尔	COMPANY_OF_INDUSTRY_23
江苏阳光	COMPANY_OF_INDUSTRY_23
金鹰股份	COMPANY_OF_INDUSTRY_23
南纺股份	COMPANY_OF_INDUSTRY_23
三房巷	COMPANY_OF_INDUSTRY_23
海澜之家	COMPANY_OF_INDUSTRY_23
红豆股份	COMPANY_OF_INDUSTRY_23
华纺股份	COMPANY_OF_INDUSTRY_23
凤竹纺织	COMPANY_OF_INDUSTRY_23
XD龙头股	COMPANY_OF_INDUSTRY_23
上海三毛	COMPANY_OF_INDUSTRY_23
海欣股份	COMPANY_OF_INDUSTRY_23
杉杉股份	COMPANY_OF_INDUSTRY_23
航民股份	COMPANY_OF_INDUSTRY_23
神州长城	COMPANY_OF_INDUSTRY_23
常山股份	COMPANY_OF_INDUSTRY_23
三毛派神	COMPANY_OF_INDUSTRY_23
天山纺织	COMPANY_OF_INDUSTRY_23
华茂股份	COMPANY_OF_INDUSTRY_23
中银绒业	COMPANY_OF_INDUSTRY_23
伟星股份	COMPANY_OF_INDUSTRY_23
霞客环保	COMPANY_OF_INDUSTRY_23
七匹狼	COMPANY_OF_INDUSTRY_23
众和股份	COMPANY_OF_INDUSTRY_23
凯瑞德	COMPANY_OF_INDUSTRY_23
孚日股份	COMPANY_OF_INDUSTRY_23
新野纺织	COMPANY_OF_INDUSTRY_23
报喜鸟	COMPANY_OF_INDUSTRY_23
山东如意	COMPANY_OF_INDUSTRY_23
奥特佳	COMPANY_OF_INDUSTRY_23
美邦服饰	COMPANY_OF_INDUSTRY_23
星期六	COMPANY_OF_INDUSTRY_23
罗莱生活	COMPANY_OF_INDUSTRY_23
富安娜	COMPANY_OF_INDUSTRY_23
联发股份	COMPANY_OF_INDUSTRY_23
梦洁股份	COMPANY_OF_INDUSTRY_23
嘉欣丝绸	COMPANY_OF_INDUSTRY_23
凯撒股份	COMPANY_OF_INDUSTRY_23
探路者	COMPANY_OF_INDUSTRY_23
鲁泰A	COMPANY_OF_INDUSTRY_23
希努尔	COMPANY_OF_INDUSTRY_23
嘉麟杰	COMPANY_OF_INDUSTRY_23
朗姿股份	COMPANY_OF_INDUSTRY_23
步森股份	COMPANY_OF_INDUSTRY_23
九牧王	COMPANY_OF_INDUSTRY_23
百隆东方	COMPANY_OF_INDUSTRY_23
华斯股份	COMPANY_OF_INDUSTRY_23
旷达科技	COMPANY_OF_INDUSTRY_23
奥康国际	COMPANY_OF_INDUSTRY_23
乔治白	COMPANY_OF_INDUSTRY_23
贵人鸟	COMPANY_OF_INDUSTRY_23
际华集团	COMPANY_OF_INDUSTRY_23
跨境通	COMPANY_OF_INDUSTRY_23
棒杰股份	COMPANY_OF_INDUSTRY_23
新澳股份	COMPANY_OF_INDUSTRY_23
健盛集团	COMPANY_OF_INDUSTRY_23
歌力思	COMPANY_OF_INDUSTRY_23
宏良股份	COMPANY_OF_INDUSTRY_23
维格娜丝	COMPANY_OF_INDUSTRY_23
摩登大道	COMPANY_OF_INDUSTRY_23
鹿港文化	COMPANY_OF_INDUSTRY_23
红蜻蜓	COMPANY_OF_INDUSTRY_23
柏堡龙	COMPANY_OF_INDUSTRY_23
汇洁股份	COMPANY_OF_INDUSTRY_23
金发拉比	COMPANY_OF_INDUSTRY_23
多喜爱	COMPANY_OF_INDUSTRY_23
天创时尚	COMPANY_OF_INDUSTRY_23
哈森股份	COMPANY_OF_INDUSTRY_23
金宇车城	COMPANY_OF_INDUSTRY_23
华升股份	COMPANY_OF_INDUSTRY_23
南极电商	COMPANY_OF_INDUSTRY_23
美欣达	COMPANY_OF_INDUSTRY_23
ST明科	COMPANY_OF_INDUSTRY_24
兴发集团	COMPANY_OF_INDUSTRY_24
商赢环球	COMPANY_OF_INDUSTRY_24
宝硕股份	COMPANY_OF_INDUSTRY_24
巨化股份	COMPANY_OF_INDUSTRY_24
*ST黑化	COMPANY_OF_INDUSTRY_24
赤天化	COMPANY_OF_INDUSTRY_24
昌九生化	COMPANY_OF_INDUSTRY_24
*ST沧大	COMPANY_OF_INDUSTRY_24
两面针	COMPANY_OF_INDUSTRY_24
太化股份	COMPANY_OF_INDUSTRY_24
*ST南化	COMPANY_OF_INDUSTRY_24
万华化学	COMPANY_OF_INDUSTRY_24
上海家化	COMPANY_OF_INDUSTRY_24
*ST亚星	COMPANY_OF_INDUSTRY_24
兰太实业	COMPANY_OF_INDUSTRY_24
浙江龙盛	COMPANY_OF_INDUSTRY_24
红星发展	COMPANY_OF_INDUSTRY_24
天科股份	COMPANY_OF_INDUSTRY_24
三友化工	COMPANY_OF_INDUSTRY_24
双良节能	COMPANY_OF_INDUSTRY_24
广东榕泰	COMPANY_OF_INDUSTRY_24
氯碱化工	COMPANY_OF_INDUSTRY_24
三爱富	COMPANY_OF_INDUSTRY_24
金牛化工	COMPANY_OF_INDUSTRY_24
*ST云维	COMPANY_OF_INDUSTRY_24
江苏索普	COMPANY_OF_INDUSTRY_24
祥龙电业	COMPANY_OF_INDUSTRY_24
新奥股份	COMPANY_OF_INDUSTRY_24
丹化科技	COMPANY_OF_INDUSTRY_24
雷鸣科化	COMPANY_OF_INDUSTRY_24
滨化股份	COMPANY_OF_INDUSTRY_24
华锦股份	COMPANY_OF_INDUSTRY_24
金路集团	COMPANY_OF_INDUSTRY_24
广州浪奇	COMPANY_OF_INDUSTRY_24
渝三峡A	COMPANY_OF_INDUSTRY_24
天茂集团	COMPANY_OF_INDUSTRY_24
英力特	COMPANY_OF_INDUSTRY_24
远兴能源	COMPANY_OF_INDUSTRY_24
双环科技	COMPANY_OF_INDUSTRY_24
南风化工	COMPANY_OF_INDUSTRY_24
山西三维	COMPANY_OF_INDUSTRY_24
方大化工	COMPANY_OF_INDUSTRY_24
山东海化	COMPANY_OF_INDUSTRY_24
久联发展	COMPANY_OF_INDUSTRY_24
德美化工	COMPANY_OF_INDUSTRY_24
*ST江化	COMPANY_OF_INDUSTRY_24
黑猫股份	COMPANY_OF_INDUSTRY_24
中泰化学	COMPANY_OF_INDUSTRY_24
南岭民爆	COMPANY_OF_INDUSTRY_24
*ST兴化	COMPANY_OF_INDUSTRY_24
湘潭电化	COMPANY_OF_INDUSTRY_24
安纳达	COMPANY_OF_INDUSTRY_24
中核钛白	COMPANY_OF_INDUSTRY_24
红宝丽	COMPANY_OF_INDUSTRY_24
合力泰	COMPANY_OF_INDUSTRY_24
江南化工	COMPANY_OF_INDUSTRY_24
联化科技	COMPANY_OF_INDUSTRY_24
彩虹精化	COMPANY_OF_INDUSTRY_24
乐通股份	COMPANY_OF_INDUSTRY_24
永太科技	COMPANY_OF_INDUSTRY_24
同德化工	COMPANY_OF_INDUSTRY_24
天原集团	COMPANY_OF_INDUSTRY_24
多氟多	COMPANY_OF_INDUSTRY_24
齐翔腾达	COMPANY_OF_INDUSTRY_24
雅克科技	COMPANY_OF_INDUSTRY_24
必康股份	COMPANY_OF_INDUSTRY_24
硅宝科技	COMPANY_OF_INDUSTRY_24
回天新材	COMPANY_OF_INDUSTRY_24
鼎龙股份	COMPANY_OF_INDUSTRY_24
天龙集团	COMPANY_OF_INDUSTRY_24
安诺其	COMPANY_OF_INDUSTRY_24
三聚环保	COMPANY_OF_INDUSTRY_24
奥克股份	COMPANY_OF_INDUSTRY_24
双龙股份	COMPANY_OF_INDUSTRY_24
新开源	COMPANY_OF_INDUSTRY_24
天马精化	COMPANY_OF_INDUSTRY_24
亿利洁能	COMPANY_OF_INDUSTRY_24
青松股份	COMPANY_OF_INDUSTRY_24
宝利国际	COMPANY_OF_INDUSTRY_24
北化股份	COMPANY_OF_INDUSTRY_24
皖维高新	COMPANY_OF_INDUSTRY_24
雅化集团	COMPANY_OF_INDUSTRY_24
西陇科学	COMPANY_OF_INDUSTRY_24
恒大高新	COMPANY_OF_INDUSTRY_24
金禾实业	COMPANY_OF_INDUSTRY_24
瑞丰高材	COMPANY_OF_INDUSTRY_24
国瓷材料	COMPANY_OF_INDUSTRY_24
宏昌电子	COMPANY_OF_INDUSTRY_24
宝莫股份	COMPANY_OF_INDUSTRY_24
科斯伍德	COMPANY_OF_INDUSTRY_24
雅本化学	COMPANY_OF_INDUSTRY_24
天齐锂业	COMPANY_OF_INDUSTRY_24
安利股份	COMPANY_OF_INDUSTRY_24
中化国际	COMPANY_OF_INDUSTRY_24
赞宇科技	COMPANY_OF_INDUSTRY_24
卫星石化	COMPANY_OF_INDUSTRY_24
宏大爆破	COMPANY_OF_INDUSTRY_24
恒逸石化	COMPANY_OF_INDUSTRY_24
元力股份	COMPANY_OF_INDUSTRY_24
天赐材料	COMPANY_OF_INDUSTRY_24
云南盐化	COMPANY_OF_INDUSTRY_24
佰利联	COMPANY_OF_INDUSTRY_24
百川股份	COMPANY_OF_INDUSTRY_24
建新股份	COMPANY_OF_INDUSTRY_24
闰土股份	COMPANY_OF_INDUSTRY_24
龙星化工	COMPANY_OF_INDUSTRY_24
万润股份	COMPANY_OF_INDUSTRY_24
富邦股份	COMPANY_OF_INDUSTRY_24
和邦生物	COMPANY_OF_INDUSTRY_24
光华科技	COMPANY_OF_INDUSTRY_24
阳谷华泰	COMPANY_OF_INDUSTRY_24
科隆精化	COMPANY_OF_INDUSTRY_24
金浦钛业	COMPANY_OF_INDUSTRY_24
凯美特气	COMPANY_OF_INDUSTRY_24
君正集团	COMPANY_OF_INDUSTRY_24
金力泰	COMPANY_OF_INDUSTRY_24
亚邦股份	COMPANY_OF_INDUSTRY_24
航天工程	COMPANY_OF_INDUSTRY_24
飞凯材料	COMPANY_OF_INDUSTRY_24
万盛股份	COMPANY_OF_INDUSTRY_24
恒通科技	COMPANY_OF_INDUSTRY_24
强力新材	COMPANY_OF_INDUSTRY_24
世龙实业	COMPANY_OF_INDUSTRY_24
醋化股份	COMPANY_OF_INDUSTRY_24
雪峰科技	COMPANY_OF_INDUSTRY_24
金科娱乐	COMPANY_OF_INDUSTRY_24
石大胜华	COMPANY_OF_INDUSTRY_24
兄弟科技	COMPANY_OF_INDUSTRY_24
川金诺	COMPANY_OF_INDUSTRY_24
井神股份	COMPANY_OF_INDUSTRY_24
华谊集团	COMPANY_OF_INDUSTRY_24
嘉澳环保	COMPANY_OF_INDUSTRY_24
凯龙股份	COMPANY_OF_INDUSTRY_24
洪汇新材	COMPANY_OF_INDUSTRY_24
丰元股份	COMPANY_OF_INDUSTRY_24
世名科技	COMPANY_OF_INDUSTRY_24
盐湖股份	COMPANY_OF_INDUSTRY_24
诚志股份	COMPANY_OF_INDUSTRY_24
三棵树	COMPANY_OF_INDUSTRY_24
嘉化能源	COMPANY_OF_INDUSTRY_24
蓝晓科技	COMPANY_OF_INDUSTRY_24
濮阳惠成	COMPANY_OF_INDUSTRY_24
国恩股份	COMPANY_OF_INDUSTRY_24
传化股份	COMPANY_OF_INDUSTRY_24
银禧科技	COMPANY_OF_INDUSTRY_25
天晟新材	COMPANY_OF_INDUSTRY_25
顺威股份	COMPANY_OF_INDUSTRY_25
海南橡胶	COMPANY_OF_INDUSTRY_25
海达股份	COMPANY_OF_INDUSTRY_25
金发科技	COMPANY_OF_INDUSTRY_25
凌云股份	COMPANY_OF_INDUSTRY_25
金鸿能源	COMPANY_OF_INDUSTRY_25
国风塑业	COMPANY_OF_INDUSTRY_25
佛塑科技	COMPANY_OF_INDUSTRY_25
鸿达兴业	COMPANY_OF_INDUSTRY_25
沧州明珠	COMPANY_OF_INDUSTRY_25
宏达新材	COMPANY_OF_INDUSTRY_25
三力士	COMPANY_OF_INDUSTRY_25
双箭股份	COMPANY_OF_INDUSTRY_25
双象股份	COMPANY_OF_INDUSTRY_25
康耐特	COMPANY_OF_INDUSTRY_25
星星科技	COMPANY_OF_INDUSTRY_25
永利股份	COMPANY_OF_INDUSTRY_25
金利科技	COMPANY_OF_INDUSTRY_25
昌红科技	COMPANY_OF_INDUSTRY_25
普利特	COMPANY_OF_INDUSTRY_25
日科化学	COMPANY_OF_INDUSTRY_25
永高股份	COMPANY_OF_INDUSTRY_25
同大股份	COMPANY_OF_INDUSTRY_25
华峰超纤	COMPANY_OF_INDUSTRY_25
世纪华通	COMPANY_OF_INDUSTRY_25
顾地科技	COMPANY_OF_INDUSTRY_25
毅昌股份	COMPANY_OF_INDUSTRY_25
福斯特	COMPANY_OF_INDUSTRY_25
瑞尔特	COMPANY_OF_INDUSTRY_25
杭州高新	COMPANY_OF_INDUSTRY_25
中鼎股份	COMPANY_OF_INDUSTRY_25
歌华有线	COMPANY_OF_INDUSTRY_26
中视传媒	COMPANY_OF_INDUSTRY_26
时代出版	COMPANY_OF_INDUSTRY_26
新华传媒	COMPANY_OF_INDUSTRY_26
广电网络	COMPANY_OF_INDUSTRY_26
博瑞传播	COMPANY_OF_INDUSTRY_26
皖新传媒	COMPANY_OF_INDUSTRY_26
出版传媒	COMPANY_OF_INDUSTRY_26
华闻传媒	COMPANY_OF_INDUSTRY_26
电广传媒	COMPANY_OF_INDUSTRY_26
粤传媒	COMPANY_OF_INDUSTRY_26
天威视讯	COMPANY_OF_INDUSTRY_26
奥飞娱乐	COMPANY_OF_INDUSTRY_26
省广股份	COMPANY_OF_INDUSTRY_26
华谊兄弟	COMPANY_OF_INDUSTRY_26
金亚科技	COMPANY_OF_INDUSTRY_26
蓝色光标	COMPANY_OF_INDUSTRY_26
华谊嘉信	COMPANY_OF_INDUSTRY_26
当代东方	COMPANY_OF_INDUSTRY_26
乐视网	COMPANY_OF_INDUSTRY_26
中南传媒	COMPANY_OF_INDUSTRY_26
中文传媒	COMPANY_OF_INDUSTRY_26
华策影视	COMPANY_OF_INDUSTRY_26
长江传媒	COMPANY_OF_INDUSTRY_26
华数传媒	COMPANY_OF_INDUSTRY_26
华录百纳	COMPANY_OF_INDUSTRY_26
吉视传媒	COMPANY_OF_INDUSTRY_26
新文化	COMPANY_OF_INDUSTRY_26
浙报传媒	COMPANY_OF_INDUSTRY_26
湖北广电	COMPANY_OF_INDUSTRY_26
天舟文化	COMPANY_OF_INDUSTRY_26
光线传媒	COMPANY_OF_INDUSTRY_26
大地传媒	COMPANY_OF_INDUSTRY_26
凤凰传媒	COMPANY_OF_INDUSTRY_26
长城动漫	COMPANY_OF_INDUSTRY_26
视觉中国	COMPANY_OF_INDUSTRY_26
长城影视	COMPANY_OF_INDUSTRY_26
江苏有线	COMPANY_OF_INDUSTRY_26
思美传媒	COMPANY_OF_INDUSTRY_26
腾信股份	COMPANY_OF_INDUSTRY_26
万达院线	COMPANY_OF_INDUSTRY_26
中文在线	COMPANY_OF_INDUSTRY_26
唐德影视	COMPANY_OF_INDUSTRY_26
龙韵股份	COMPANY_OF_INDUSTRY_26
申科股份	COMPANY_OF_INDUSTRY_26
引力传媒	COMPANY_OF_INDUSTRY_26
慈文传媒	COMPANY_OF_INDUSTRY_26
东方明珠	COMPANY_OF_INDUSTRY_26
读者传媒	COMPANY_OF_INDUSTRY_26
南方传媒	COMPANY_OF_INDUSTRY_26
大晟文化	COMPANY_OF_INDUSTRY_26
联创互联	COMPANY_OF_INDUSTRY_26
文投控股	COMPANY_OF_INDUSTRY_26
当代明诚	COMPANY_OF_INDUSTRY_26
印纪传媒	COMPANY_OF_INDUSTRY_26
暴风集团	COMPANY_OF_INDUSTRY_26
城市传媒	COMPANY_OF_INDUSTRY_26
北京文化	COMPANY_OF_INDUSTRY_26
*ST生物	COMPANY_OF_INDUSTRY_26
华媒控股	COMPANY_OF_INDUSTRY_26
万家文化	COMPANY_OF_INDUSTRY_26
幸福蓝海	COMPANY_OF_INDUSTRY_26
新华文轩	COMPANY_OF_INDUSTRY_26
中国电影	COMPANY_OF_INDUSTRY_26
鞍重股份	COMPANY_OF_INDUSTRY_27
创元科技	COMPANY_OF_INDUSTRY_27
东杰智能	COMPANY_OF_INDUSTRY_27
海源机械	COMPANY_OF_INDUSTRY_27
金海环境	COMPANY_OF_INDUSTRY_27
标准股份	COMPANY_OF_INDUSTRY_27
道森股份	COMPANY_OF_INDUSTRY_27
广日股份	COMPANY_OF_INDUSTRY_27
爱司凯	COMPANY_OF_INDUSTRY_27
博实股份	COMPANY_OF_INDUSTRY_27
电光科技	COMPANY_OF_INDUSTRY_27
海伦哲	COMPANY_OF_INDUSTRY_27
*ST星马	COMPANY_OF_INDUSTRY_27
安徽合力	COMPANY_OF_INDUSTRY_27
宝色股份	COMPANY_OF_INDUSTRY_27
创力集团	COMPANY_OF_INDUSTRY_27
达意隆	COMPANY_OF_INDUSTRY_27
东方精工	COMPANY_OF_INDUSTRY_27
高澜股份	COMPANY_OF_INDUSTRY_27
海默科技	COMPANY_OF_INDUSTRY_27
*ST冀装	COMPANY_OF_INDUSTRY_27
宝德股份	COMPANY_OF_INDUSTRY_27
慈星股份	COMPANY_OF_INDUSTRY_27
菲达环保	COMPANY_OF_INDUSTRY_27
航天晨光	COMPANY_OF_INDUSTRY_27
北玻股份	COMPANY_OF_INDUSTRY_27
达刚路机	COMPANY_OF_INDUSTRY_27
光力科技	COMPANY_OF_INDUSTRY_27
杭氧股份	COMPANY_OF_INDUSTRY_27
中潜股份	COMPANY_OF_INDUSTRY_27
华明装备	COMPANY_OF_INDUSTRY_27
华舟应急	COMPANY_OF_INDUSTRY_27
兰州民百	COMPANY_OF_INDUSTRY_28
辽宁成大	COMPANY_OF_INDUSTRY_28
汉商集团	COMPANY_OF_INDUSTRY_28
友好集团	COMPANY_OF_INDUSTRY_28
新华百货	COMPANY_OF_INDUSTRY_28
杭州解百	COMPANY_OF_INDUSTRY_28
津劝业	COMPANY_OF_INDUSTRY_28
益民集团	COMPANY_OF_INDUSTRY_28
百联股份	COMPANY_OF_INDUSTRY_28
茂业商业	COMPANY_OF_INDUSTRY_28
上海九百	COMPANY_OF_INDUSTRY_28
银座股份	COMPANY_OF_INDUSTRY_28
王府井	COMPANY_OF_INDUSTRY_28
北京城乡	COMPANY_OF_INDUSTRY_28
百大集团	COMPANY_OF_INDUSTRY_28
秋林集团	COMPANY_OF_INDUSTRY_28
三联商社	COMPANY_OF_INDUSTRY_28
合肥百货	COMPANY_OF_INDUSTRY_28
通程控股	COMPANY_OF_INDUSTRY_28
鄂武商A	COMPANY_OF_INDUSTRY_28
国际医学	COMPANY_OF_INDUSTRY_28
昆百大A	COMPANY_OF_INDUSTRY_28
西安民生	COMPANY_OF_INDUSTRY_28
大连友谊	COMPANY_OF_INDUSTRY_28
厦门信达	COMPANY_OF_INDUSTRY_28
中兴商业	COMPANY_OF_INDUSTRY_28
中百集团	COMPANY_OF_INDUSTRY_28
武汉中商	COMPANY_OF_INDUSTRY_28
华联股份	COMPANY_OF_INDUSTRY_28
广州友谊	COMPANY_OF_INDUSTRY_28
苏宁云商	COMPANY_OF_INDUSTRY_28
广百股份	COMPANY_OF_INDUSTRY_28
步步高	COMPANY_OF_INDUSTRY_28
新华都	COMPANY_OF_INDUSTRY_28
友阿股份	COMPANY_OF_INDUSTRY_28
*ST人乐	COMPANY_OF_INDUSTRY_28
海宁皮城	COMPANY_OF_INDUSTRY_28
爱施德	COMPANY_OF_INDUSTRY_28
天虹商场	COMPANY_OF_INDUSTRY_28
吉峰农机	COMPANY_OF_INDUSTRY_28
重庆百货	COMPANY_OF_INDUSTRY_28
宏图高科	COMPANY_OF_INDUSTRY_28
ST成城	COMPANY_OF_INDUSTRY_28
中央商场	COMPANY_OF_INDUSTRY_28
江苏舜天	COMPANY_OF_INDUSTRY_28
*ST商城	COMPANY_OF_INDUSTRY_28
大东方	COMPANY_OF_INDUSTRY_28
华联综超	COMPANY_OF_INDUSTRY_28
小商品城	COMPANY_OF_INDUSTRY_28
海航基础	COMPANY_OF_INDUSTRY_28
汇通能源	COMPANY_OF_INDUSTRY_28
新世界	COMPANY_OF_INDUSTRY_28
豫园商城	COMPANY_OF_INDUSTRY_28
南京新百	COMPANY_OF_INDUSTRY_28
东百集团	COMPANY_OF_INDUSTRY_28
大商股份	COMPANY_OF_INDUSTRY_28
欧亚集团	COMPANY_OF_INDUSTRY_28
南宁百货	COMPANY_OF_INDUSTRY_28
首商股份	COMPANY_OF_INDUSTRY_28
文峰股份	COMPANY_OF_INDUSTRY_28
永辉超市	COMPANY_OF_INDUSTRY_28
三江购物	COMPANY_OF_INDUSTRY_28
徐家汇	COMPANY_OF_INDUSTRY_28
轻纺城	COMPANY_OF_INDUSTRY_28
宁波中百	COMPANY_OF_INDUSTRY_28
翠微股份	COMPANY_OF_INDUSTRY_28
红旗连锁	COMPANY_OF_INDUSTRY_28
庞大集团	COMPANY_OF_INDUSTRY_28
快乐购	COMPANY_OF_INDUSTRY_28
三夫户外	COMPANY_OF_INDUSTRY_28
深赛格	COMPANY_OF_INDUSTRY_28
汇嘉时代	COMPANY_OF_INDUSTRY_28
漳州发展	COMPANY_OF_INDUSTRY_28
物产中拓	COMPANY_OF_INDUSTRY_28
开开实业	COMPANY_OF_INDUSTRY_28
日照港	COMPANY_OF_INDUSTRY_29
上港集团	COMPANY_OF_INDUSTRY_29
中海发展	COMPANY_OF_INDUSTRY_29
锦州港	COMPANY_OF_INDUSTRY_29
重庆港九	COMPANY_OF_INDUSTRY_29
营口港	COMPANY_OF_INDUSTRY_29
中远航运	COMPANY_OF_INDUSTRY_29
皖江物流	COMPANY_OF_INDUSTRY_29
亚通股份	COMPANY_OF_INDUSTRY_29
天津港	COMPANY_OF_INDUSTRY_29
天海投资	COMPANY_OF_INDUSTRY_29
宁波海运	COMPANY_OF_INDUSTRY_29
中海海盛	COMPANY_OF_INDUSTRY_29
连云港	COMPANY_OF_INDUSTRY_29
中海集运	COMPANY_OF_INDUSTRY_29
招商轮船	COMPANY_OF_INDUSTRY_29
中国远洋	COMPANY_OF_INDUSTRY_29
深赤湾A	COMPANY_OF_INDUSTRY_29
北部湾港	COMPANY_OF_INDUSTRY_29
厦门港务	COMPANY_OF_INDUSTRY_29
南京港	COMPANY_OF_INDUSTRY_29
海峡股份	COMPANY_OF_INDUSTRY_29
中昌海运	COMPANY_OF_INDUSTRY_29
盐田港	COMPANY_OF_INDUSTRY_29
唐山港	COMPANY_OF_INDUSTRY_29
宁波港	COMPANY_OF_INDUSTRY_29
珠海港	COMPANY_OF_INDUSTRY_29
大连港	COMPANY_OF_INDUSTRY_29
渤海轮渡	COMPANY_OF_INDUSTRY_29
长航凤凰	COMPANY_OF_INDUSTRY_29
京投发展	COMPANY_OF_INDUSTRY_30
中房地产	COMPANY_OF_INDUSTRY_30
大名城	COMPANY_OF_INDUSTRY_30
荣安地产	COMPANY_OF_INDUSTRY_30
中国国贸	COMPANY_OF_INDUSTRY_30
泰禾集团	COMPANY_OF_INDUSTRY_30
宁波富达	COMPANY_OF_INDUSTRY_30
深大通	COMPANY_OF_INDUSTRY_30
新华联	COMPANY_OF_INDUSTRY_30
南京高科	COMPANY_OF_INDUSTRY_30
冠城大通	COMPANY_OF_INDUSTRY_30
海泰发展	COMPANY_OF_INDUSTRY_30
浙江东日	COMPANY_OF_INDUSTRY_30
大龙地产	COMPANY_OF_INDUSTRY_30
香江控股	COMPANY_OF_INDUSTRY_30
卧龙地产	COMPANY_OF_INDUSTRY_30
格力地产	COMPANY_OF_INDUSTRY_30
新湖中宝	COMPANY_OF_INDUSTRY_30
鲁商置业	COMPANY_OF_INDUSTRY_30
天津松江	COMPANY_OF_INDUSTRY_30
云南城投	COMPANY_OF_INDUSTRY_30
华业资本	COMPANY_OF_INDUSTRY_30
万通地产	COMPANY_OF_INDUSTRY_30
北京城建	COMPANY_OF_INDUSTRY_30
天房发展	COMPANY_OF_INDUSTRY_30
华发股份	COMPANY_OF_INDUSTRY_30
首开股份	COMPANY_OF_INDUSTRY_30
金地集团	COMPANY_OF_INDUSTRY_30
粤泰股份	COMPANY_OF_INDUSTRY_30
空港股份	COMPANY_OF_INDUSTRY_30
华丽家族	COMPANY_OF_INDUSTRY_30
栖霞建设	COMPANY_OF_INDUSTRY_30
绿地控股	COMPANY_OF_INDUSTRY_30
嘉宝集团	COMPANY_OF_INDUSTRY_30
新黄浦	COMPANY_OF_INDUSTRY_30
浦东金桥	COMPANY_OF_INDUSTRY_30
万业企业	COMPANY_OF_INDUSTRY_30
外高桥	COMPANY_OF_INDUSTRY_30
信达地产	COMPANY_OF_INDUSTRY_30
陆家嘴	COMPANY_OF_INDUSTRY_30
天地源	COMPANY_OF_INDUSTRY_30
*ST中企	COMPANY_OF_INDUSTRY_30
珠江实业	COMPANY_OF_INDUSTRY_30
匹凸匹	COMPANY_OF_INDUSTRY_30
S前锋	COMPANY_OF_INDUSTRY_30
实达集团	COMPANY_OF_INDUSTRY_30
苏州高新	COMPANY_OF_INDUSTRY_30
华远地产	COMPANY_OF_INDUSTRY_30
中茵股份	COMPANY_OF_INDUSTRY_30
上实发展	COMPANY_OF_INDUSTRY_30
东方银星	COMPANY_OF_INDUSTRY_30
西藏城投	COMPANY_OF_INDUSTRY_30
京能置业	COMPANY_OF_INDUSTRY_30
天业股份	COMPANY_OF_INDUSTRY_30
世茂股份	COMPANY_OF_INDUSTRY_30
张江高科	COMPANY_OF_INDUSTRY_30
北辰实业	COMPANY_OF_INDUSTRY_30
万科A	COMPANY_OF_INDUSTRY_30
世纪星源	COMPANY_OF_INDUSTRY_30
深振业A	COMPANY_OF_INDUSTRY_30
中国宝安	COMPANY_OF_INDUSTRY_30
深物业A	COMPANY_OF_INDUSTRY_30
沙河股份	COMPANY_OF_INDUSTRY_30
深深房A	COMPANY_OF_INDUSTRY_30
中粮地产	COMPANY_OF_INDUSTRY_30
中洲控股	COMPANY_OF_INDUSTRY_30
中航地产	COMPANY_OF_INDUSTRY_30
泛海控股	COMPANY_OF_INDUSTRY_30
皇庭国际	COMPANY_OF_INDUSTRY_30
金融街	COMPANY_OF_INDUSTRY_30
绿景控股	COMPANY_OF_INDUSTRY_30
*ST珠江	COMPANY_OF_INDUSTRY_30
渝开发	COMPANY_OF_INDUSTRY_30
万泽股份	COMPANY_OF_INDUSTRY_30
广宇发展	COMPANY_OF_INDUSTRY_30
中天城投	COMPANY_OF_INDUSTRY_30
湖南投资	COMPANY_OF_INDUSTRY_30
莱茵体育	COMPANY_OF_INDUSTRY_30
海德股份	COMPANY_OF_INDUSTRY_30
粤宏远A	COMPANY_OF_INDUSTRY_30
阳光股份	COMPANY_OF_INDUSTRY_30
绵石投资	COMPANY_OF_INDUSTRY_30
海航投资	COMPANY_OF_INDUSTRY_30
高新发展	COMPANY_OF_INDUSTRY_30
顺发恒业	COMPANY_OF_INDUSTRY_30
万方发展	COMPANY_OF_INDUSTRY_30
金科股份	COMPANY_OF_INDUSTRY_30
美好集团	COMPANY_OF_INDUSTRY_30
荣丰控股	COMPANY_OF_INDUSTRY_30
阳光城	COMPANY_OF_INDUSTRY_30
苏宁环球	COMPANY_OF_INDUSTRY_30
中国武夷	COMPANY_OF_INDUSTRY_30
财信发展	COMPANY_OF_INDUSTRY_30
津滨发展	COMPANY_OF_INDUSTRY_30
嘉凯城	COMPANY_OF_INDUSTRY_30
福星股份	COMPANY_OF_INDUSTRY_30
中关村	COMPANY_OF_INDUSTRY_30
中南建设	COMPANY_OF_INDUSTRY_30
天保基建	COMPANY_OF_INDUSTRY_30
中弘股份	COMPANY_OF_INDUSTRY_30
世荣兆业	COMPANY_OF_INDUSTRY_30
大港股份	COMPANY_OF_INDUSTRY_30
广宇集团	COMPANY_OF_INDUSTRY_30
荣盛发展	COMPANY_OF_INDUSTRY_30
合肥城建	COMPANY_OF_INDUSTRY_30
滨江集团	COMPANY_OF_INDUSTRY_30
世联行	COMPANY_OF_INDUSTRY_30
南国置业	COMPANY_OF_INDUSTRY_30
保利地产	COMPANY_OF_INDUSTRY_30
浙江广厦	COMPANY_OF_INDUSTRY_30
银亿股份	COMPANY_OF_INDUSTRY_30
电子城	COMPANY_OF_INDUSTRY_30
ST亚太	COMPANY_OF_INDUSTRY_30
铁岭新城	COMPANY_OF_INDUSTRY_30
华联控股	COMPANY_OF_INDUSTRY_30
华侨城A	COMPANY_OF_INDUSTRY_30
凤凰股份	COMPANY_OF_INDUSTRY_30
宋都股份	COMPANY_OF_INDUSTRY_30
三湘股份	COMPANY_OF_INDUSTRY_30
长春经开	COMPANY_OF_INDUSTRY_30
新城控股	COMPANY_OF_INDUSTRY_30
招商蛇口	COMPANY_OF_INDUSTRY_30
上海临港	COMPANY_OF_INDUSTRY_30
东旭蓝天	COMPANY_OF_INDUSTRY_30
哈高科	COMPANY_OF_INDUSTRY_30
廊坊发展	COMPANY_OF_INDUSTRY_30
光明地产	COMPANY_OF_INDUSTRY_30
京汉股份	COMPANY_OF_INDUSTRY_30
海印股份	COMPANY_OF_INDUSTRY_30
蓝光发展	COMPANY_OF_INDUSTRY_30
迪马股份	COMPANY_OF_INDUSTRY_30
*ST山水	COMPANY_OF_INDUSTRY_30
武昌鱼	COMPANY_OF_INDUSTRY_30
华夏幸福	COMPANY_OF_INDUSTRY_30
市北高新	COMPANY_OF_INDUSTRY_30
华鑫股份	COMPANY_OF_INDUSTRY_30
城投控股	COMPANY_OF_INDUSTRY_30
华宇软件	COMPANY_OF_INDUSTRY_31
赛为智能	COMPANY_OF_INDUSTRY_31
顺网科技	COMPANY_OF_INDUSTRY_31
同有科技	COMPANY_OF_INDUSTRY_31
久其软件	COMPANY_OF_INDUSTRY_31
北信源	COMPANY_OF_INDUSTRY_31
东方通	COMPANY_OF_INDUSTRY_31
迅游科技	COMPANY_OF_INDUSTRY_31
榕基软件	COMPANY_OF_INDUSTRY_31
美亚柏科	COMPANY_OF_INDUSTRY_31
浪潮软件	COMPANY_OF_INDUSTRY_31
荣之联	COMPANY_OF_INDUSTRY_31
天玑科技	COMPANY_OF_INDUSTRY_31
新开普	COMPANY_OF_INDUSTRY_31
创业软件	COMPANY_OF_INDUSTRY_31
金桥信息	COMPANY_OF_INDUSTRY_31
信息发展	COMPANY_OF_INDUSTRY_31
海联讯	COMPANY_OF_INDUSTRY_31
华胜天成	COMPANY_OF_INDUSTRY_31
荣科科技	COMPANY_OF_INDUSTRY_31
四方精创	COMPANY_OF_INDUSTRY_31
川大智胜	COMPANY_OF_INDUSTRY_31
银之杰	COMPANY_OF_INDUSTRY_31
真视通	COMPANY_OF_INDUSTRY_31
神州泰岳	COMPANY_OF_INDUSTRY_31
浩云科技	COMPANY_OF_INDUSTRY_31
达实智能	COMPANY_OF_INDUSTRY_31
南威软件	COMPANY_OF_INDUSTRY_31
赢时胜	COMPANY_OF_INDUSTRY_31
数字政通	COMPANY_OF_INDUSTRY_31
飞利信	COMPANY_OF_INDUSTRY_31
湘邮科技	COMPANY_OF_INDUSTRY_31
四维图新	COMPANY_OF_INDUSTRY_31
绿盟科技	COMPANY_OF_INDUSTRY_31
皖通科技	COMPANY_OF_INDUSTRY_31
用友网络	COMPANY_OF_INDUSTRY_31
东软集团	COMPANY_OF_INDUSTRY_31
京蓝科技	COMPANY_OF_INDUSTRY_31
航天信息	COMPANY_OF_INDUSTRY_31
博通股份	COMPANY_OF_INDUSTRY_31
银江股份	COMPANY_OF_INDUSTRY_31
超图软件	COMPANY_OF_INDUSTRY_31
太极股份	COMPANY_OF_INDUSTRY_31
中海科技	COMPANY_OF_INDUSTRY_31
万达信息	COMPANY_OF_INDUSTRY_31
天泽信息	COMPANY_OF_INDUSTRY_31
旋极信息	COMPANY_OF_INDUSTRY_31
恒华科技	COMPANY_OF_INDUSTRY_31
天源迪科	COMPANY_OF_INDUSTRY_31
润和软件	COMPANY_OF_INDUSTRY_31
南天信息	COMPANY_OF_INDUSTRY_31
亿阳信通	COMPANY_OF_INDUSTRY_31
联络互动	COMPANY_OF_INDUSTRY_31
高伟达	COMPANY_OF_INDUSTRY_31
中安消	COMPANY_OF_INDUSTRY_31
拓尔思	COMPANY_OF_INDUSTRY_31
石基信息	COMPANY_OF_INDUSTRY_31
远光软件	COMPANY_OF_INDUSTRY_31
东华软件	COMPANY_OF_INDUSTRY_31
佳创视讯	COMPANY_OF_INDUSTRY_31
华力创通	COMPANY_OF_INDUSTRY_31
任子行	COMPANY_OF_INDUSTRY_31
启明星辰	COMPANY_OF_INDUSTRY_31
网宿科技	COMPANY_OF_INDUSTRY_31
易联众	COMPANY_OF_INDUSTRY_31
博彦科技	COMPANY_OF_INDUSTRY_31
中国软件	COMPANY_OF_INDUSTRY_31
飞天诚信	COMPANY_OF_INDUSTRY_31
汉鼎宇佑	COMPANY_OF_INDUSTRY_31
蓝盾股份	COMPANY_OF_INDUSTRY_31
易华录	COMPANY_OF_INDUSTRY_31
同花顺	COMPANY_OF_INDUSTRY_31
宝信软件	COMPANY_OF_INDUSTRY_31
鼎捷软件	COMPANY_OF_INDUSTRY_31
银信科技	COMPANY_OF_INDUSTRY_31
积成电子	COMPANY_OF_INDUSTRY_31
汉得信息	COMPANY_OF_INDUSTRY_31
科大讯飞	COMPANY_OF_INDUSTRY_31
立思辰	COMPANY_OF_INDUSTRY_31
捷成股份	COMPANY_OF_INDUSTRY_31
启明信息	COMPANY_OF_INDUSTRY_31
华平股份	COMPANY_OF_INDUSTRY_31
卫士通	COMPANY_OF_INDUSTRY_31
广联达	COMPANY_OF_INDUSTRY_31
大智慧	COMPANY_OF_INDUSTRY_31
恒生电子	COMPANY_OF_INDUSTRY_31
信雅达	COMPANY_OF_INDUSTRY_31
千方科技	COMPANY_OF_INDUSTRY_31
东方国信	COMPANY_OF_INDUSTRY_31
卫宁健康	COMPANY_OF_INDUSTRY_31
中科金财	COMPANY_OF_INDUSTRY_31
佳都科技	COMPANY_OF_INDUSTRY_31
汉王科技	COMPANY_OF_INDUSTRY_31
长亮科技	COMPANY_OF_INDUSTRY_31
金证股份	COMPANY_OF_INDUSTRY_31
延华智能	COMPANY_OF_INDUSTRY_31
盛讯达	COMPANY_OF_INDUSTRY_31
科大国创	COMPANY_OF_INDUSTRY_31
游族网络	COMPANY_OF_INDUSTRY_31
维宏股份	COMPANY_OF_INDUSTRY_31
N辰安	COMPANY_OF_INDUSTRY_31
N博思	COMPANY_OF_INDUSTRY_31
超讯通信	COMPANY_OF_INDUSTRY_31
世纪游轮	COMPANY_OF_INDUSTRY_31
恒泰实达	COMPANY_OF_INDUSTRY_31
英唐智控	COMPANY_OF_INDUSTRY_32
北京君正	COMPANY_OF_INDUSTRY_32
天喻信息	COMPANY_OF_INDUSTRY_32
联建光电	COMPANY_OF_INDUSTRY_32
利亚德	COMPANY_OF_INDUSTRY_32
国星光电	COMPANY_OF_INDUSTRY_32
晓程科技	COMPANY_OF_INDUSTRY_32
江海股份	COMPANY_OF_INDUSTRY_32
银河磁体	COMPANY_OF_INDUSTRY_32
锦富新材	COMPANY_OF_INDUSTRY_32
丹邦科技	COMPANY_OF_INDUSTRY_32
安洁科技	COMPANY_OF_INDUSTRY_32
长方集团	COMPANY_OF_INDUSTRY_32
聚飞光电	COMPANY_OF_INDUSTRY_32
上海贝岭	COMPANY_OF_INDUSTRY_32
生益科技	COMPANY_OF_INDUSTRY_32
铜峰电子	COMPANY_OF_INDUSTRY_32
阳光照明	COMPANY_OF_INDUSTRY_32
天通股份	COMPANY_OF_INDUSTRY_32
旭光股份	COMPANY_OF_INDUSTRY_32
精伦电子	COMPANY_OF_INDUSTRY_32
华微电子	COMPANY_OF_INDUSTRY_32
联创光电	COMPANY_OF_INDUSTRY_32
动力源	COMPANY_OF_INDUSTRY_32
士兰微	COMPANY_OF_INDUSTRY_32
科力远	COMPANY_OF_INDUSTRY_32
法拉电子	COMPANY_OF_INDUSTRY_32
长电科技	COMPANY_OF_INDUSTRY_32
飞乐音响	COMPANY_OF_INDUSTRY_32
三安光电	COMPANY_OF_INDUSTRY_32
彩虹股份	COMPANY_OF_INDUSTRY_32
大连控股	COMPANY_OF_INDUSTRY_32
四创电子	COMPANY_OF_INDUSTRY_32
深华发A	COMPANY_OF_INDUSTRY_32
德赛电池	COMPANY_OF_INDUSTRY_32
深天马A	COMPANY_OF_INDUSTRY_32
深圳华强	COMPANY_OF_INDUSTRY_32
东旭光电	COMPANY_OF_INDUSTRY_32
佛山照明	COMPANY_OF_INDUSTRY_32
风华高科	COMPANY_OF_INDUSTRY_32
东方电子	COMPANY_OF_INDUSTRY_32
京东方A	COMPANY_OF_INDUSTRY_32
华东科技	COMPANY_OF_INDUSTRY_32
超声电子	COMPANY_OF_INDUSTRY_32
中科三环	COMPANY_OF_INDUSTRY_32
航天电器	COMPANY_OF_INDUSTRY_32
国光电器	COMPANY_OF_INDUSTRY_32
紫光国芯	COMPANY_OF_INDUSTRY_32
得润电子	COMPANY_OF_INDUSTRY_32
横店东磁	COMPANY_OF_INDUSTRY_32
雪莱特	COMPANY_OF_INDUSTRY_32
苏州固锝	COMPANY_OF_INDUSTRY_32
康强电子	COMPANY_OF_INDUSTRY_32
科陆电子	COMPANY_OF_INDUSTRY_32
中环股份	COMPANY_OF_INDUSTRY_32
天津普林	COMPANY_OF_INDUSTRY_32
麦达数字	COMPANY_OF_INDUSTRY_32
顺络电子	COMPANY_OF_INDUSTRY_32
通富微电	COMPANY_OF_INDUSTRY_32
中航光电	COMPANY_OF_INDUSTRY_32
华天科技	COMPANY_OF_INDUSTRY_32
巴士在线	COMPANY_OF_INDUSTRY_32
利达光电	COMPANY_OF_INDUSTRY_32
*ST东晶	COMPANY_OF_INDUSTRY_32
福晶科技	COMPANY_OF_INDUSTRY_32
歌尔股份	COMPANY_OF_INDUSTRY_32
水晶光电	COMPANY_OF_INDUSTRY_32
*ST宇顺	COMPANY_OF_INDUSTRY_32
威创股份	COMPANY_OF_INDUSTRY_32
七星电子	COMPANY_OF_INDUSTRY_32
南洋科技	COMPANY_OF_INDUSTRY_32
和而泰	COMPANY_OF_INDUSTRY_32
兴森科技	COMPANY_OF_INDUSTRY_32
亿纬锂能	COMPANY_OF_INDUSTRY_32
天龙光电	COMPANY_OF_INDUSTRY_32
金龙机电	COMPANY_OF_INDUSTRY_32
台基股份	COMPANY_OF_INDUSTRY_32
南都电源	COMPANY_OF_INDUSTRY_32
国民技术	COMPANY_OF_INDUSTRY_32
航天机电	COMPANY_OF_INDUSTRY_32
太极实业	COMPANY_OF_INDUSTRY_32
莱宝高科	COMPANY_OF_INDUSTRY_32
立讯精密	COMPANY_OF_INDUSTRY_32
瑞丰光电	COMPANY_OF_INDUSTRY_32
华灿光电	COMPANY_OF_INDUSTRY_32
中航电测	COMPANY_OF_INDUSTRY_32
鸿利智汇	COMPANY_OF_INDUSTRY_32
欧菲光	COMPANY_OF_INDUSTRY_32
华映科技	COMPANY_OF_INDUSTRY_32
拓日新能	COMPANY_OF_INDUSTRY_32
环旭电子	COMPANY_OF_INDUSTRY_32
猛狮科技	COMPANY_OF_INDUSTRY_32
沪电股份	COMPANY_OF_INDUSTRY_32
奥拓电子	COMPANY_OF_INDUSTRY_32
洲明科技	COMPANY_OF_INDUSTRY_32
茂硕电源	COMPANY_OF_INDUSTRY_32
中颖电子	COMPANY_OF_INDUSTRY_32
光韵达	COMPANY_OF_INDUSTRY_32
万润科技	COMPANY_OF_INDUSTRY_32
乾照光电	COMPANY_OF_INDUSTRY_32
雷曼股份	COMPANY_OF_INDUSTRY_32
麦捷科技	COMPANY_OF_INDUSTRY_32
协鑫集成	COMPANY_OF_INDUSTRY_32
达华智能	COMPANY_OF_INDUSTRY_32
长盈精密	COMPANY_OF_INDUSTRY_32
苏试试验	COMPANY_OF_INDUSTRY_32
中京电子	COMPANY_OF_INDUSTRY_32
金安国纪	COMPANY_OF_INDUSTRY_32
勤上光电	COMPANY_OF_INDUSTRY_32
雄韬股份	COMPANY_OF_INDUSTRY_32
三环集团	COMPANY_OF_INDUSTRY_32
扬杰科技	COMPANY_OF_INDUSTRY_32
海洋王	COMPANY_OF_INDUSTRY_32
艾比森	COMPANY_OF_INDUSTRY_32
好利来	COMPANY_OF_INDUSTRY_32
火炬电子	COMPANY_OF_INDUSTRY_32
超华科技	COMPANY_OF_INDUSTRY_32
长信科技	COMPANY_OF_INDUSTRY_32
珈伟股份	COMPANY_OF_INDUSTRY_32
木林森	COMPANY_OF_INDUSTRY_32
共达电声	COMPANY_OF_INDUSTRY_32
鹏辉能源	COMPANY_OF_INDUSTRY_32
正业科技	COMPANY_OF_INDUSTRY_32
艾华集团	COMPANY_OF_INDUSTRY_32
田中精机	COMPANY_OF_INDUSTRY_32
中光防雷	COMPANY_OF_INDUSTRY_32
赢合科技	COMPANY_OF_INDUSTRY_32
全志科技	COMPANY_OF_INDUSTRY_32
惠伦晶体	COMPANY_OF_INDUSTRY_32
力源信息	COMPANY_OF_INDUSTRY_32
金运激光	COMPANY_OF_INDUSTRY_32
依顿电子	COMPANY_OF_INDUSTRY_32
胜宏科技	COMPANY_OF_INDUSTRY_32
博敏电子	COMPANY_OF_INDUSTRY_32
可立克	COMPANY_OF_INDUSTRY_32
中新科技	COMPANY_OF_INDUSTRY_32
九有股份	COMPANY_OF_INDUSTRY_32
振华科技	COMPANY_OF_INDUSTRY_32
亿晶光电	COMPANY_OF_INDUSTRY_32
华工科技	COMPANY_OF_INDUSTRY_32
名家汇	COMPANY_OF_INDUSTRY_32
宏发股份	COMPANY_OF_INDUSTRY_32
久之洋	COMPANY_OF_INDUSTRY_32
N华锋	COMPANY_OF_INDUSTRY_32
兴源环境	COMPANY_OF_INDUSTRY_33
森远股份	COMPANY_OF_INDUSTRY_33
京运通	COMPANY_OF_INDUSTRY_33
江苏神通	COMPANY_OF_INDUSTRY_33
日发精机	COMPANY_OF_INDUSTRY_33
天桥起重	COMPANY_OF_INDUSTRY_33
中金环境	COMPANY_OF_INDUSTRY_33
鸿特精密	COMPANY_OF_INDUSTRY_33
东方电热	COMPANY_OF_INDUSTRY_33
阳光电源	COMPANY_OF_INDUSTRY_33
天广消防	COMPANY_OF_INDUSTRY_33
*ST恒立	COMPANY_OF_INDUSTRY_33
双环传动	COMPANY_OF_INDUSTRY_33
山东墨龙	COMPANY_OF_INDUSTRY_33
科林环保	COMPANY_OF_INDUSTRY_33
新时达	COMPANY_OF_INDUSTRY_33
天沃科技	COMPANY_OF_INDUSTRY_33
山东章鼓	COMPANY_OF_INDUSTRY_33
开山股份	COMPANY_OF_INDUSTRY_33
蓝英装备	COMPANY_OF_INDUSTRY_33
三一重工	COMPANY_OF_INDUSTRY_33
太原重工	COMPANY_OF_INDUSTRY_33
哈空调	COMPANY_OF_INDUSTRY_33
全柴动力	COMPANY_OF_INDUSTRY_33
青海华鼎	COMPANY_OF_INDUSTRY_33
北方股份	COMPANY_OF_INDUSTRY_33
振华重工	COMPANY_OF_INDUSTRY_33
航天动力	COMPANY_OF_INDUSTRY_33
龙净环保	COMPANY_OF_INDUSTRY_33
北方导航	COMPANY_OF_INDUSTRY_33
华光股份	COMPANY_OF_INDUSTRY_33
科达洁能	COMPANY_OF_INDUSTRY_33
*ST中发	COMPANY_OF_INDUSTRY_33
金自天正	COMPANY_OF_INDUSTRY_33
天地科技	COMPANY_OF_INDUSTRY_33
龙溪股份	COMPANY_OF_INDUSTRY_33
海立股份	COMPANY_OF_INDUSTRY_33
*ST昆机	COMPANY_OF_INDUSTRY_33
厦工股份	COMPANY_OF_INDUSTRY_33
上海机电	COMPANY_OF_INDUSTRY_33
上柴股份	COMPANY_OF_INDUSTRY_33
上工申贝	COMPANY_OF_INDUSTRY_33
京城股份	COMPANY_OF_INDUSTRY_33
渤海活塞	COMPANY_OF_INDUSTRY_33
北方创业	COMPANY_OF_INDUSTRY_33
建设机械	COMPANY_OF_INDUSTRY_33
晋亿实业	COMPANY_OF_INDUSTRY_33
中国一重	COMPANY_OF_INDUSTRY_33
陕鼓动力	COMPANY_OF_INDUSTRY_33
中联重科	COMPANY_OF_INDUSTRY_33
潍柴动力	COMPANY_OF_INDUSTRY_33
华意压缩	COMPANY_OF_INDUSTRY_33
沈阳机床	COMPANY_OF_INDUSTRY_33
徐工机械	COMPANY_OF_INDUSTRY_33
江南红箭	COMPANY_OF_INDUSTRY_33
柳工	COMPANY_OF_INDUSTRY_33
大冷股份	COMPANY_OF_INDUSTRY_33
苏常柴A	COMPANY_OF_INDUSTRY_33
宝塔实业	COMPANY_OF_INDUSTRY_33
*ST济柴	COMPANY_OF_INDUSTRY_33
山推股份	COMPANY_OF_INDUSTRY_33
中核科技	COMPANY_OF_INDUSTRY_33
京山轻机	COMPANY_OF_INDUSTRY_33
秦川机床	COMPANY_OF_INDUSTRY_33
石化机械	COMPANY_OF_INDUSTRY_33
云内动力	COMPANY_OF_INDUSTRY_33
河北宣工	COMPANY_OF_INDUSTRY_33
精功科技	COMPANY_OF_INDUSTRY_33
天奇股份	COMPANY_OF_INDUSTRY_33
盾安环境	COMPANY_OF_INDUSTRY_33
中捷资源	COMPANY_OF_INDUSTRY_33
山东威达	COMPANY_OF_INDUSTRY_33
轴研科技	COMPANY_OF_INDUSTRY_33
山河智能	COMPANY_OF_INDUSTRY_33
威海广泰	COMPANY_OF_INDUSTRY_33
天马股份	COMPANY_OF_INDUSTRY_33
利欧股份	COMPANY_OF_INDUSTRY_33
新光圆成	COMPANY_OF_INDUSTRY_33
汉钟精机	COMPANY_OF_INDUSTRY_33
宁波东力	COMPANY_OF_INDUSTRY_33
江特电机	COMPANY_OF_INDUSTRY_33
方正电机	COMPANY_OF_INDUSTRY_33
大连重工	COMPANY_OF_INDUSTRY_33
华东数控	COMPANY_OF_INDUSTRY_33
大洋电机	COMPANY_OF_INDUSTRY_33
海陆重工	COMPANY_OF_INDUSTRY_33
西仪股份	COMPANY_OF_INDUSTRY_33
浙富控股	COMPANY_OF_INDUSTRY_33
川润股份	COMPANY_OF_INDUSTRY_33
神开股份	COMPANY_OF_INDUSTRY_33
博深工具	COMPANY_OF_INDUSTRY_33
天润曲轴	COMPANY_OF_INDUSTRY_33
新朋股份	COMPANY_OF_INDUSTRY_33
赛象科技	COMPANY_OF_INDUSTRY_33
泰尔重工	COMPANY_OF_INDUSTRY_33
杰瑞股份	COMPANY_OF_INDUSTRY_33
台海核电	COMPANY_OF_INDUSTRY_33
康力电梯	COMPANY_OF_INDUSTRY_33
远东传动	COMPANY_OF_INDUSTRY_33
长江润发	COMPANY_OF_INDUSTRY_33
南风股份	COMPANY_OF_INDUSTRY_33
中科电气	COMPANY_OF_INDUSTRY_33
烟台冰轮	COMPANY_OF_INDUSTRY_33
智慧农业	COMPANY_OF_INDUSTRY_33
山东矿机	COMPANY_OF_INDUSTRY_33
丰东股份	COMPANY_OF_INDUSTRY_33
天顺风能	COMPANY_OF_INDUSTRY_33
新界泵业	COMPANY_OF_INDUSTRY_33
杭锅股份	COMPANY_OF_INDUSTRY_33
南方轴承	COMPANY_OF_INDUSTRY_33
通裕重工	COMPANY_OF_INDUSTRY_33
长荣股份	COMPANY_OF_INDUSTRY_33
佳士科技	COMPANY_OF_INDUSTRY_33
江南嘉捷	COMPANY_OF_INDUSTRY_33
郑煤机	COMPANY_OF_INDUSTRY_33
中南文化	COMPANY_OF_INDUSTRY_33
新筑股份	COMPANY_OF_INDUSTRY_33
华伍股份	COMPANY_OF_INDUSTRY_33
智云股份	COMPANY_OF_INDUSTRY_33
金通灵	COMPANY_OF_INDUSTRY_33
华东重机	COMPANY_OF_INDUSTRY_33
恒立液压	COMPANY_OF_INDUSTRY_33
华西能源	COMPANY_OF_INDUSTRY_33
三丰智能	COMPANY_OF_INDUSTRY_33
利君股份	COMPANY_OF_INDUSTRY_33
中际装备	COMPANY_OF_INDUSTRY_33
冀凯股份	COMPANY_OF_INDUSTRY_33
一拖股份	COMPANY_OF_INDUSTRY_33
聚龙股份	COMPANY_OF_INDUSTRY_33
华昌达	COMPANY_OF_INDUSTRY_33
首航节能	COMPANY_OF_INDUSTRY_33
晶盛机电	COMPANY_OF_INDUSTRY_33
中信重工	COMPANY_OF_INDUSTRY_33
科新机电	COMPANY_OF_INDUSTRY_33
智慧松德	COMPANY_OF_INDUSTRY_33
富瑞特装	COMPANY_OF_INDUSTRY_33
雪人股份	COMPANY_OF_INDUSTRY_33
信质电机	COMPANY_OF_INDUSTRY_33
远大智能	COMPANY_OF_INDUSTRY_33
纽威股份	COMPANY_OF_INDUSTRY_33
天翔环境	COMPANY_OF_INDUSTRY_33
应流股份	COMPANY_OF_INDUSTRY_33
天业通联	COMPANY_OF_INDUSTRY_33
隆华节能	COMPANY_OF_INDUSTRY_33
华中数控	COMPANY_OF_INDUSTRY_33
亚威股份	COMPANY_OF_INDUSTRY_33
蓝科高新	COMPANY_OF_INDUSTRY_33
开能环保	COMPANY_OF_INDUSTRY_33
华宏科技	COMPANY_OF_INDUSTRY_33
南通锻压	COMPANY_OF_INDUSTRY_33
金明精机	COMPANY_OF_INDUSTRY_33
龙源技术	COMPANY_OF_INDUSTRY_33
乐金健康	COMPANY_OF_INDUSTRY_33
艾迪西	COMPANY_OF_INDUSTRY_33
坚瑞消防	COMPANY_OF_INDUSTRY_33
润邦股份	COMPANY_OF_INDUSTRY_33
锐奇股份	COMPANY_OF_INDUSTRY_33
杭齿前进	COMPANY_OF_INDUSTRY_33
派思股份	COMPANY_OF_INDUSTRY_33
金轮股份	COMPANY_OF_INDUSTRY_33
斯莱克	COMPANY_OF_INDUSTRY_33
华电重工	COMPANY_OF_INDUSTRY_33
隆鑫通用	COMPANY_OF_INDUSTRY_33
合锻智能	COMPANY_OF_INDUSTRY_33
中电电机	COMPANY_OF_INDUSTRY_33
地尔汉宇	COMPANY_OF_INDUSTRY_33
宁波精达	COMPANY_OF_INDUSTRY_33
瑞凌股份	COMPANY_OF_INDUSTRY_33
新研股份	COMPANY_OF_INDUSTRY_33
龙马环卫	COMPANY_OF_INDUSTRY_33
诺力股份	COMPANY_OF_INDUSTRY_33
伊之密	COMPANY_OF_INDUSTRY_33
汇金股份	COMPANY_OF_INDUSTRY_33
五洋科技	COMPANY_OF_INDUSTRY_33
依米康	COMPANY_OF_INDUSTRY_33
劲拓股份	COMPANY_OF_INDUSTRY_33
浙江鼎力	COMPANY_OF_INDUSTRY_33
诚益通	COMPANY_OF_INDUSTRY_33
埃斯顿	COMPANY_OF_INDUSTRY_33
三垒股份	COMPANY_OF_INDUSTRY_33
星光农机	COMPANY_OF_INDUSTRY_33
金石东方	COMPANY_OF_INDUSTRY_33
普丽盛	COMPANY_OF_INDUSTRY_33
福鞍股份	COMPANY_OF_INDUSTRY_33
金雷风电	COMPANY_OF_INDUSTRY_33
金盾股份	COMPANY_OF_INDUSTRY_33
中泰股份	COMPANY_OF_INDUSTRY_33
康跃科技	COMPANY_OF_INDUSTRY_33
鲍斯股份	COMPANY_OF_INDUSTRY_33
先导智能	COMPANY_OF_INDUSTRY_33
南兴装备	COMPANY_OF_INDUSTRY_33
永创智能	COMPANY_OF_INDUSTRY_33
雪浪环境	COMPANY_OF_INDUSTRY_33
昊志机电	COMPANY_OF_INDUSTRY_33
天成自控	COMPANY_OF_INDUSTRY_33
日机密封	COMPANY_OF_INDUSTRY_33
蓝黛传动	COMPANY_OF_INDUSTRY_33
厚普股份	COMPANY_OF_INDUSTRY_33
中国核电	COMPANY_OF_INDUSTRY_33
银宝山新	COMPANY_OF_INDUSTRY_33
中坚科技	COMPANY_OF_INDUSTRY_33
四方冷链	COMPANY_OF_INDUSTRY_33
国机通用	COMPANY_OF_INDUSTRY_33
永和智控	COMPANY_OF_INDUSTRY_33
新美星	COMPANY_OF_INDUSTRY_33
中亚股份	COMPANY_OF_INDUSTRY_33
*ST橡塑	COMPANY_OF_INDUSTRY_33
微光股份	COMPANY_OF_INDUSTRY_33
北矿科技	COMPANY_OF_INDUSTRY_33
湘电股份	COMPANY_OF_INDUSTRY_33
佳电股份	COMPANY_OF_INDUSTRY_33
大族激光	COMPANY_OF_INDUSTRY_33
国睿科技	COMPANY_OF_INDUSTRY_33
天华院	COMPANY_OF_INDUSTRY_33
天鹅股份	COMPANY_OF_INDUSTRY_33
上海沪工	COMPANY_OF_INDUSTRY_33
东音股份	COMPANY_OF_INDUSTRY_33
德宏股份	COMPANY_OF_INDUSTRY_33
开创国际	COMPANY_OF_INDUSTRY_34
亚盛集团	COMPANY_OF_INDUSTRY_34
金健米业	COMPANY_OF_INDUSTRY_34
冠农股份	COMPANY_OF_INDUSTRY_34
大湖股份	COMPANY_OF_INDUSTRY_34
敦煌种业	COMPANY_OF_INDUSTRY_34
新农开发	COMPANY_OF_INDUSTRY_34
通威股份	COMPANY_OF_INDUSTRY_34
好当家	COMPANY_OF_INDUSTRY_34
福成股份	COMPANY_OF_INDUSTRY_34
新五丰	COMPANY_OF_INDUSTRY_34
康达尔	COMPANY_OF_INDUSTRY_34
正虹科技	COMPANY_OF_INDUSTRY_34
丰乐种业	COMPANY_OF_INDUSTRY_34
罗牛山	COMPANY_OF_INDUSTRY_34
中水渔业	COMPANY_OF_INDUSTRY_34
新希望	COMPANY_OF_INDUSTRY_34
隆平高科	COMPANY_OF_INDUSTRY_34
登海种业	COMPANY_OF_INDUSTRY_34
*ST獐岛	COMPANY_OF_INDUSTRY_34
东方海洋	COMPANY_OF_INDUSTRY_34
天康生物	COMPANY_OF_INDUSTRY_34
天邦股份	COMPANY_OF_INDUSTRY_34
正邦科技	COMPANY_OF_INDUSTRY_34
*ST创疗	COMPANY_OF_INDUSTRY_34
民和股份	COMPANY_OF_INDUSTRY_34
圣农发展	COMPANY_OF_INDUSTRY_34
海大集团	COMPANY_OF_INDUSTRY_34
华英农业	COMPANY_OF_INDUSTRY_34
大北农	COMPANY_OF_INDUSTRY_34
荃银高科	COMPANY_OF_INDUSTRY_34
新赛股份	COMPANY_OF_INDUSTRY_34
北大荒	COMPANY_OF_INDUSTRY_34
万福生科	COMPANY_OF_INDUSTRY_34
朗源股份	COMPANY_OF_INDUSTRY_34
天山生物	COMPANY_OF_INDUSTRY_34
农发种业	COMPANY_OF_INDUSTRY_34
万向德农	COMPANY_OF_INDUSTRY_34
唐人神	COMPANY_OF_INDUSTRY_34
雏鹰农牧	COMPANY_OF_INDUSTRY_34
好想你	COMPANY_OF_INDUSTRY_34
大康农业	COMPANY_OF_INDUSTRY_34
壹桥海参	COMPANY_OF_INDUSTRY_34
星河生物	COMPANY_OF_INDUSTRY_34
国联水产	COMPANY_OF_INDUSTRY_34
益生股份	COMPANY_OF_INDUSTRY_34
溢多利	COMPANY_OF_INDUSTRY_34
百洋股份	COMPANY_OF_INDUSTRY_34
中粮生化	COMPANY_OF_INDUSTRY_34
西部牧业	COMPANY_OF_INDUSTRY_34
辉隆股份	COMPANY_OF_INDUSTRY_34
神农基因	COMPANY_OF_INDUSTRY_34
牧原股份	COMPANY_OF_INDUSTRY_34
金新农	COMPANY_OF_INDUSTRY_34
仙坛股份	COMPANY_OF_INDUSTRY_34
禾丰牧业	COMPANY_OF_INDUSTRY_34
金河生物	COMPANY_OF_INDUSTRY_34
龙大肉食	COMPANY_OF_INDUSTRY_34
雪榕生物	COMPANY_OF_INDUSTRY_34
温氏股份	COMPANY_OF_INDUSTRY_34
香梨股份	COMPANY_OF_INDUSTRY_34
三六五网	COMPANY_OF_INDUSTRY_35
朗玛信息	COMPANY_OF_INDUSTRY_35
汇冠股份	COMPANY_OF_INDUSTRY_35
大恒科技	COMPANY_OF_INDUSTRY_35
方正科技	COMPANY_OF_INDUSTRY_35
中电广通	COMPANY_OF_INDUSTRY_35
浙大网新	COMPANY_OF_INDUSTRY_35
天津磁卡	COMPANY_OF_INDUSTRY_35
华东电脑	COMPANY_OF_INDUSTRY_35
深科技	COMPANY_OF_INDUSTRY_35
长城电脑	COMPANY_OF_INDUSTRY_35
海虹控股	COMPANY_OF_INDUSTRY_35
长城信息	COMPANY_OF_INDUSTRY_35
中信国安	COMPANY_OF_INDUSTRY_35
浪潮信息	COMPANY_OF_INDUSTRY_35
分众传媒	COMPANY_OF_INDUSTRY_35
软控股份	COMPANY_OF_INDUSTRY_35
金智科技	COMPANY_OF_INDUSTRY_35
生意宝	COMPANY_OF_INDUSTRY_35
恒宝股份	COMPANY_OF_INDUSTRY_35
北斗星通	COMPANY_OF_INDUSTRY_35
广电运通	COMPANY_OF_INDUSTRY_35
远望谷	COMPANY_OF_INDUSTRY_35
御银股份	COMPANY_OF_INDUSTRY_35
海得控制	COMPANY_OF_INDUSTRY_35
二三四五	COMPANY_OF_INDUSTRY_35
证通电子	COMPANY_OF_INDUSTRY_35
三泰控股	COMPANY_OF_INDUSTRY_35
漫步者	COMPANY_OF_INDUSTRY_35
卓翼科技	COMPANY_OF_INDUSTRY_35
新北洋	COMPANY_OF_INDUSTRY_35
科远股份	COMPANY_OF_INDUSTRY_35
新亚制程	COMPANY_OF_INDUSTRY_35
朗科科技	COMPANY_OF_INDUSTRY_35
三五互联	COMPANY_OF_INDUSTRY_35
中青宝	COMPANY_OF_INDUSTRY_35
海兰信	COMPANY_OF_INDUSTRY_35
焦点科技	COMPANY_OF_INDUSTRY_35
华虹计通	COMPANY_OF_INDUSTRY_35
世纪瑞尔	COMPANY_OF_INDUSTRY_35
东软载波	COMPANY_OF_INDUSTRY_35
人民网	COMPANY_OF_INDUSTRY_35
新国都	COMPANY_OF_INDUSTRY_35
方直科技	COMPANY_OF_INDUSTRY_35
安硕信息	COMPANY_OF_INDUSTRY_35
和晶科技	COMPANY_OF_INDUSTRY_35
兆日科技	COMPANY_OF_INDUSTRY_35
初灵信息	COMPANY_OF_INDUSTRY_35
神州信息	COMPANY_OF_INDUSTRY_35
浩丰科技	COMPANY_OF_INDUSTRY_35
乐凯新材	COMPANY_OF_INDUSTRY_35
大豪科技	COMPANY_OF_INDUSTRY_35
运达科技	COMPANY_OF_INDUSTRY_35
晶方科技	COMPANY_OF_INDUSTRY_35
共进股份	COMPANY_OF_INDUSTRY_35
掌趣科技	COMPANY_OF_INDUSTRY_35
创意信息	COMPANY_OF_INDUSTRY_35
欧浦智网	COMPANY_OF_INDUSTRY_35
中科曙光	COMPANY_OF_INDUSTRY_35
昆仑万维	COMPANY_OF_INDUSTRY_35
天和防务	COMPANY_OF_INDUSTRY_35
雷柏科技	COMPANY_OF_INDUSTRY_35
上海钢联	COMPANY_OF_INDUSTRY_35
京天利	COMPANY_OF_INDUSTRY_35
捷顺科技	COMPANY_OF_INDUSTRY_35
游久游戏	COMPANY_OF_INDUSTRY_35
天神娱乐	COMPANY_OF_INDUSTRY_35
康拓红外	COMPANY_OF_INDUSTRY_35
*ST盈方	COMPANY_OF_INDUSTRY_35
三七互娱	COMPANY_OF_INDUSTRY_35
雷科防务	COMPANY_OF_INDUSTRY_35
普路通	COMPANY_OF_INDUSTRY_35
神思电子	COMPANY_OF_INDUSTRY_35
思维列控	COMPANY_OF_INDUSTRY_35
久远银海	COMPANY_OF_INDUSTRY_35
盛天网络	COMPANY_OF_INDUSTRY_35
中科创达	COMPANY_OF_INDUSTRY_35
润欣科技	COMPANY_OF_INDUSTRY_35
运盛医疗	COMPANY_OF_INDUSTRY_35
深纺织A	COMPANY_OF_INDUSTRY_35
深桑达A	COMPANY_OF_INDUSTRY_35
多伦科技	COMPANY_OF_INDUSTRY_35
景嘉微	COMPANY_OF_INDUSTRY_35
云赛智联	COMPANY_OF_INDUSTRY_35
紫光股份	COMPANY_OF_INDUSTRY_35
恺英网络	COMPANY_OF_INDUSTRY_35
高升控股	COMPANY_OF_INDUSTRY_35
天润数娱	COMPANY_OF_INDUSTRY_35
联创电子	COMPANY_OF_INDUSTRY_35
长江投资	COMPANY_OF_INDUSTRY_36
铁龙物流	COMPANY_OF_INDUSTRY_36
外运发展	COMPANY_OF_INDUSTRY_36
北巴传媒	COMPANY_OF_INDUSTRY_36
江西长运	COMPANY_OF_INDUSTRY_36
大众交通	COMPANY_OF_INDUSTRY_36
锦江投资	COMPANY_OF_INDUSTRY_36
强生控股	COMPANY_OF_INDUSTRY_36
中储股份	COMPANY_OF_INDUSTRY_36
保税科技	COMPANY_OF_INDUSTRY_36
申通地铁	COMPANY_OF_INDUSTRY_36
大秦铁路	COMPANY_OF_INDUSTRY_36
广深铁路	COMPANY_OF_INDUSTRY_36
中国中期	COMPANY_OF_INDUSTRY_36
飞马国际	COMPANY_OF_INDUSTRY_36
澳洋顺昌	COMPANY_OF_INDUSTRY_36
富临运业	COMPANY_OF_INDUSTRY_36
新宁物流	COMPANY_OF_INDUSTRY_36
宜昌交运	COMPANY_OF_INDUSTRY_36
龙洲股份	COMPANY_OF_INDUSTRY_36
恒基达鑫	COMPANY_OF_INDUSTRY_36
飞力达	COMPANY_OF_INDUSTRY_36
华贸物流	COMPANY_OF_INDUSTRY_36
华鹏飞	COMPANY_OF_INDUSTRY_36
象屿股份	COMPANY_OF_INDUSTRY_36
恒通股份	COMPANY_OF_INDUSTRY_36
万林股份	COMPANY_OF_INDUSTRY_36
音飞储存	COMPANY_OF_INDUSTRY_36
东方时尚	COMPANY_OF_INDUSTRY_36
禾嘉股份	COMPANY_OF_INDUSTRY_36
海汽集团	COMPANY_OF_INDUSTRY_36
大杨创世	COMPANY_OF_INDUSTRY_36
建发股份	COMPANY_OF_INDUSTRY_36
长久物流	COMPANY_OF_INDUSTRY_36
天顺股份	COMPANY_OF_INDUSTRY_36
永鼎股份	COMPANY_OF_INDUSTRY_37
波导股份	COMPANY_OF_INDUSTRY_37
大唐电信	COMPANY_OF_INDUSTRY_37
长江通信	COMPANY_OF_INDUSTRY_37
信威集团	COMPANY_OF_INDUSTRY_37
亨通光电	COMPANY_OF_INDUSTRY_37
烽火通信	COMPANY_OF_INDUSTRY_37
中天科技	COMPANY_OF_INDUSTRY_37
上海普天	COMPANY_OF_INDUSTRY_37
南京熊猫	COMPANY_OF_INDUSTRY_37
东方通信	COMPANY_OF_INDUSTRY_37
中兴通讯	COMPANY_OF_INDUSTRY_37
特发信息	COMPANY_OF_INDUSTRY_37
航天发展	COMPANY_OF_INDUSTRY_37
汇源通信	COMPANY_OF_INDUSTRY_37
天音控股	COMPANY_OF_INDUSTRY_37
高鸿股份	COMPANY_OF_INDUSTRY_37
星美联合	COMPANY_OF_INDUSTRY_37
东信和平	COMPANY_OF_INDUSTRY_37
同洲电子	COMPANY_OF_INDUSTRY_37
新海宜	COMPANY_OF_INDUSTRY_37
三维通信	COMPANY_OF_INDUSTRY_37
北纬通信	COMPANY_OF_INDUSTRY_37
武汉凡谷	COMPANY_OF_INDUSTRY_37
奥维通信	COMPANY_OF_INDUSTRY_37
拓维信息	COMPANY_OF_INDUSTRY_37
光迅科技	COMPANY_OF_INDUSTRY_37
辉煌科技	COMPANY_OF_INDUSTRY_37
日海通讯	COMPANY_OF_INDUSTRY_37
键桥通讯	COMPANY_OF_INDUSTRY_37
合众思壮	COMPANY_OF_INDUSTRY_37
星网锐捷	COMPANY_OF_INDUSTRY_37
三元达	COMPANY_OF_INDUSTRY_37
华星创业	COMPANY_OF_INDUSTRY_37
梅泰诺	COMPANY_OF_INDUSTRY_37
世纪鼎利	COMPANY_OF_INDUSTRY_37
数码视讯	COMPANY_OF_INDUSTRY_37
恒信移动	COMPANY_OF_INDUSTRY_37
硕贝德	COMPANY_OF_INDUSTRY_37
信维通信	COMPANY_OF_INDUSTRY_37
通鼎互联	COMPANY_OF_INDUSTRY_37
大富科技	COMPANY_OF_INDUSTRY_37
亿通科技	COMPANY_OF_INDUSTRY_37
佳讯飞鸿	COMPANY_OF_INDUSTRY_37
烽火电子	COMPANY_OF_INDUSTRY_37
吴通控股	COMPANY_OF_INDUSTRY_37
邦讯技术	COMPANY_OF_INDUSTRY_37
海格通信	COMPANY_OF_INDUSTRY_37
东土科技	COMPANY_OF_INDUSTRY_37
盛路通信	COMPANY_OF_INDUSTRY_37
杰赛科技	COMPANY_OF_INDUSTRY_37
富春通信	COMPANY_OF_INDUSTRY_37
振芯科技	COMPANY_OF_INDUSTRY_37
中海达	COMPANY_OF_INDUSTRY_37
宜通世纪	COMPANY_OF_INDUSTRY_37
福日电子	COMPANY_OF_INDUSTRY_37
天孚通信	COMPANY_OF_INDUSTRY_37
新易盛	COMPANY_OF_INDUSTRY_37
索菱股份	COMPANY_OF_INDUSTRY_37
茂业通信	COMPANY_OF_INDUSTRY_37
神州数码	COMPANY_OF_INDUSTRY_37
通宇通讯	COMPANY_OF_INDUSTRY_37
华讯方舟	COMPANY_OF_INDUSTRY_37
创维数字	COMPANY_OF_INDUSTRY_37
生物股份	COMPANY_OF_INDUSTRY_38
国光股份	COMPANY_OF_INDUSTRY_38
广信股份	COMPANY_OF_INDUSTRY_38
利民股份	COMPANY_OF_INDUSTRY_38
辉丰股份	COMPANY_OF_INDUSTRY_38
扬农化工	COMPANY_OF_INDUSTRY_38
利尔化学	COMPANY_OF_INDUSTRY_38
江山股份	COMPANY_OF_INDUSTRY_38
诺普信	COMPANY_OF_INDUSTRY_38
*ST蓝丰	COMPANY_OF_INDUSTRY_38
长青股份	COMPANY_OF_INDUSTRY_38
华邦健康	COMPANY_OF_INDUSTRY_38
钱江生化	COMPANY_OF_INDUSTRY_38
升华拜克	COMPANY_OF_INDUSTRY_38
国发股份	COMPANY_OF_INDUSTRY_38
新安股份	COMPANY_OF_INDUSTRY_38
湖南海利	COMPANY_OF_INDUSTRY_38
沙隆达A	COMPANY_OF_INDUSTRY_38
胜利股份	COMPANY_OF_INDUSTRY_38
安迪苏	COMPANY_OF_INDUSTRY_38
建艺集团	COMPANY_OF_INDUSTRY_39
罗顿发展	COMPANY_OF_INDUSTRY_39
东易日盛	COMPANY_OF_INDUSTRY_39
柯利达	COMPANY_OF_INDUSTRY_39
全筑股份	COMPANY_OF_INDUSTRY_39
江河集团	COMPANY_OF_INDUSTRY_39
广田集团	COMPANY_OF_INDUSTRY_39
弘高创意	COMPANY_OF_INDUSTRY_39
宝鹰股份	COMPANY_OF_INDUSTRY_39
洪涛股份	COMPANY_OF_INDUSTRY_39
金螳螂	COMPANY_OF_INDUSTRY_39
亚厦股份	COMPANY_OF_INDUSTRY_39
瑞和股份	COMPANY_OF_INDUSTRY_39
黔源电力	COMPANY_OF_INDUSTRY_40
华能国际	COMPANY_OF_INDUSTRY_40
上海电力	COMPANY_OF_INDUSTRY_40
华电国际	COMPANY_OF_INDUSTRY_40
广州发展	COMPANY_OF_INDUSTRY_40
明星电力	COMPANY_OF_INDUSTRY_40
三峡水利	COMPANY_OF_INDUSTRY_40
岷江水电	COMPANY_OF_INDUSTRY_40
联美控股	COMPANY_OF_INDUSTRY_40
桂冠电力	COMPANY_OF_INDUSTRY_40
桂东电力	COMPANY_OF_INDUSTRY_40
金山股份	COMPANY_OF_INDUSTRY_40
涪陵电力	COMPANY_OF_INDUSTRY_40
西昌电力	COMPANY_OF_INDUSTRY_40
天富能源	COMPANY_OF_INDUSTRY_40
京能电力	COMPANY_OF_INDUSTRY_40
乐山电力	COMPANY_OF_INDUSTRY_40
川投能源	COMPANY_OF_INDUSTRY_40
大连热电	COMPANY_OF_INDUSTRY_40
华电能源	COMPANY_OF_INDUSTRY_40
华银电力	COMPANY_OF_INDUSTRY_40
通宝能源	COMPANY_OF_INDUSTRY_40
国电电力	COMPANY_OF_INDUSTRY_40
内蒙华电	COMPANY_OF_INDUSTRY_40
梅雁吉祥	COMPANY_OF_INDUSTRY_40
国投电力	COMPANY_OF_INDUSTRY_40
长江电力	COMPANY_OF_INDUSTRY_40
郴电国际	COMPANY_OF_INDUSTRY_40
宁波热电	COMPANY_OF_INDUSTRY_40
文山电力	COMPANY_OF_INDUSTRY_40
大唐发电	COMPANY_OF_INDUSTRY_40
*ST南电A	COMPANY_OF_INDUSTRY_40
穗恒运A	COMPANY_OF_INDUSTRY_40
粤电力A	COMPANY_OF_INDUSTRY_40
皖能电力	COMPANY_OF_INDUSTRY_40
建投能源	COMPANY_OF_INDUSTRY_40
韶能股份	COMPANY_OF_INDUSTRY_40
宝新能源	COMPANY_OF_INDUSTRY_40
滨海能源	COMPANY_OF_INDUSTRY_40
新能泰山	COMPANY_OF_INDUSTRY_40
漳泽电力	COMPANY_OF_INDUSTRY_40
吉电股份	COMPANY_OF_INDUSTRY_40
赣能股份	COMPANY_OF_INDUSTRY_40
凯迪生态	COMPANY_OF_INDUSTRY_40
东方能源	COMPANY_OF_INDUSTRY_40
长源电力	COMPANY_OF_INDUSTRY_40
闽东电力	COMPANY_OF_INDUSTRY_40
豫能控股	COMPANY_OF_INDUSTRY_40
湖北能源	COMPANY_OF_INDUSTRY_40
浙能电力	COMPANY_OF_INDUSTRY_40
申能股份	COMPANY_OF_INDUSTRY_40
湖南发展	COMPANY_OF_INDUSTRY_40
中闽能源	COMPANY_OF_INDUSTRY_40
福能股份	COMPANY_OF_INDUSTRY_40
甘肃电投	COMPANY_OF_INDUSTRY_40
太阳能	COMPANY_OF_INDUSTRY_40
四川路桥	COMPANY_OF_INDUSTRY_41
葛洲坝	COMPANY_OF_INDUSTRY_41
上海建工	COMPANY_OF_INDUSTRY_41
浦东建设	COMPANY_OF_INDUSTRY_41
西藏天路	COMPANY_OF_INDUSTRY_41
龙元建设	COMPANY_OF_INDUSTRY_41
安徽水利	COMPANY_OF_INDUSTRY_41
腾达建设	COMPANY_OF_INDUSTRY_41
中铁二局	COMPANY_OF_INDUSTRY_41
海油工程	COMPANY_OF_INDUSTRY_41
隧道股份	COMPANY_OF_INDUSTRY_41
龙建股份	COMPANY_OF_INDUSTRY_41
科达股份	COMPANY_OF_INDUSTRY_41
中国化学	COMPANY_OF_INDUSTRY_41
中国铁建	COMPANY_OF_INDUSTRY_41
中国中铁	COMPANY_OF_INDUSTRY_41
中国中冶	COMPANY_OF_INDUSTRY_41
中国建筑	COMPANY_OF_INDUSTRY_41
北方国际	COMPANY_OF_INDUSTRY_41
天健集团	COMPANY_OF_INDUSTRY_41
中工国际	COMPANY_OF_INDUSTRY_41
粤水电	COMPANY_OF_INDUSTRY_41
宏润建设	COMPANY_OF_INDUSTRY_41
东华科技	COMPANY_OF_INDUSTRY_41
北新路桥	COMPANY_OF_INDUSTRY_41
建研集团	COMPANY_OF_INDUSTRY_41
黑牡丹	COMPANY_OF_INDUSTRY_41
成都路桥	COMPANY_OF_INDUSTRY_41
中国电建	COMPANY_OF_INDUSTRY_41
围海股份	COMPANY_OF_INDUSTRY_41
中国海诚	COMPANY_OF_INDUSTRY_41
中泰桥梁	COMPANY_OF_INDUSTRY_41
中化岩土	COMPANY_OF_INDUSTRY_41
山东路桥	COMPANY_OF_INDUSTRY_41
三维工程	COMPANY_OF_INDUSTRY_41
中衡设计	COMPANY_OF_INDUSTRY_41
苏交科	COMPANY_OF_INDUSTRY_41
宁波建工	COMPANY_OF_INDUSTRY_41
东南网架	COMPANY_OF_INDUSTRY_41
设计股份	COMPANY_OF_INDUSTRY_41
中国交建	COMPANY_OF_INDUSTRY_41
中矿资源	COMPANY_OF_INDUSTRY_41
东方新星	COMPANY_OF_INDUSTRY_41
金诚信	COMPANY_OF_INDUSTRY_41
乾景园林	COMPANY_OF_INDUSTRY_41
山鼎设计	COMPANY_OF_INDUSTRY_41
奇信股份	COMPANY_OF_INDUSTRY_41
苏州设计	COMPANY_OF_INDUSTRY_41
博信股份	COMPANY_OF_INDUSTRY_41
东湖高新	COMPANY_OF_INDUSTRY_41
海波重科	COMPANY_OF_INDUSTRY_41
合诚股份	COMPANY_OF_INDUSTRY_41
中钢国际	COMPANY_OF_INDUSTRY_41
新疆城建	COMPANY_OF_INDUSTRY_41
百利科技	COMPANY_OF_INDUSTRY_41
中国核建	COMPANY_OF_INDUSTRY_41
华建集团	COMPANY_OF_INDUSTRY_41
皖通高速	COMPANY_OF_INDUSTRY_42
中原高速	COMPANY_OF_INDUSTRY_42
福建高速	COMPANY_OF_INDUSTRY_42
楚天高速	COMPANY_OF_INDUSTRY_42
重庆路桥	COMPANY_OF_INDUSTRY_42
赣粤高速	COMPANY_OF_INDUSTRY_42
山东高速	COMPANY_OF_INDUSTRY_42
五洲交通	COMPANY_OF_INDUSTRY_42
宁沪高速	COMPANY_OF_INDUSTRY_42
深高速	COMPANY_OF_INDUSTRY_42
四川成渝	COMPANY_OF_INDUSTRY_42
龙江交通	COMPANY_OF_INDUSTRY_42
吉林高速	COMPANY_OF_INDUSTRY_42
粤高速A	COMPANY_OF_INDUSTRY_42
东莞控股	COMPANY_OF_INDUSTRY_42
海南高速	COMPANY_OF_INDUSTRY_42
现代投资	COMPANY_OF_INDUSTRY_42
华北高速	COMPANY_OF_INDUSTRY_42
康盛股份	COMPANY_OF_INDUSTRY_43
宜安科技	COMPANY_OF_INDUSTRY_43
中飞股份	COMPANY_OF_INDUSTRY_43
大金重工	COMPANY_OF_INDUSTRY_43
恒锋工具	COMPANY_OF_INDUSTRY_43
星徽精密	COMPANY_OF_INDUSTRY_43
奥瑞金	COMPANY_OF_INDUSTRY_43
胜利精密	COMPANY_OF_INDUSTRY_43
法尔胜	COMPANY_OF_INDUSTRY_43
通润装备	COMPANY_OF_INDUSTRY_43
东山精密	COMPANY_OF_INDUSTRY_43
劲胜精密	COMPANY_OF_INDUSTRY_43
宝馨科技	COMPANY_OF_INDUSTRY_43
宏磊股份	COMPANY_OF_INDUSTRY_43
春兴精工	COMPANY_OF_INDUSTRY_43
ST沪科	COMPANY_OF_INDUSTRY_43
新兴铸管	COMPANY_OF_INDUSTRY_43
金洲管道	COMPANY_OF_INDUSTRY_43
凤形股份	COMPANY_OF_INDUSTRY_43
哈尔斯	COMPANY_OF_INDUSTRY_43
巨星科技	COMPANY_OF_INDUSTRY_43
东睦股份	COMPANY_OF_INDUSTRY_43
盈峰环境	COMPANY_OF_INDUSTRY_43
贵绳股份	COMPANY_OF_INDUSTRY_43
爱康科技	COMPANY_OF_INDUSTRY_43
中集集团	COMPANY_OF_INDUSTRY_43
经纬电材	COMPANY_OF_INDUSTRY_43
力星股份	COMPANY_OF_INDUSTRY_43
巨力索具	COMPANY_OF_INDUSTRY_43
恒星科技	COMPANY_OF_INDUSTRY_43
昇兴股份	COMPANY_OF_INDUSTRY_43
丰华股份	COMPANY_OF_INDUSTRY_43
蓉胜超微	COMPANY_OF_INDUSTRY_43
鼎泰新材	COMPANY_OF_INDUSTRY_43
丽鹏股份	COMPANY_OF_INDUSTRY_43
银龙股份	COMPANY_OF_INDUSTRY_43
红宇新材	COMPANY_OF_INDUSTRY_43
玉龙股份	COMPANY_OF_INDUSTRY_43
大西洋	COMPANY_OF_INDUSTRY_43
精达股份	COMPANY_OF_INDUSTRY_43
露笑科技	COMPANY_OF_INDUSTRY_43
新日恒力	COMPANY_OF_INDUSTRY_43
中房股份	COMPANY_OF_INDUSTRY_43
方大集团	COMPANY_OF_INDUSTRY_43
世嘉科技	COMPANY_OF_INDUSTRY_43
赛福天	COMPANY_OF_INDUSTRY_43
坚朗五金	COMPANY_OF_INDUSTRY_43
安泰科技	COMPANY_OF_INDUSTRY_43
经纬纺机	COMPANY_OF_INDUSTRY_44
锦龙股份	COMPANY_OF_INDUSTRY_44
爱建集团	COMPANY_OF_INDUSTRY_44
*ST宏盛	COMPANY_OF_INDUSTRY_44
鲁银投资	COMPANY_OF_INDUSTRY_44
香溢融通	COMPANY_OF_INDUSTRY_44
陕国投A	COMPANY_OF_INDUSTRY_44
华铁科技	COMPANY_OF_INDUSTRY_44
民生控股	COMPANY_OF_INDUSTRY_44
中航资本	COMPANY_OF_INDUSTRY_44
渤海金控	COMPANY_OF_INDUSTRY_44
西水股份	COMPANY_OF_INDUSTRY_44
新力金融	COMPANY_OF_INDUSTRY_44
九鼎投资	COMPANY_OF_INDUSTRY_44
众业达	COMPANY_OF_INDUSTRY_45
特变电工	COMPANY_OF_INDUSTRY_45
天成控股	COMPANY_OF_INDUSTRY_45
长城电工	COMPANY_OF_INDUSTRY_45
国电南自	COMPANY_OF_INDUSTRY_45
华仪电气	COMPANY_OF_INDUSTRY_45
平高电气	COMPANY_OF_INDUSTRY_45
国电南瑞	COMPANY_OF_INDUSTRY_45
百利电气	COMPANY_OF_INDUSTRY_45
置信电气	COMPANY_OF_INDUSTRY_45
保变电气	COMPANY_OF_INDUSTRY_45
泰豪科技	COMPANY_OF_INDUSTRY_45
东方电气	COMPANY_OF_INDUSTRY_45
中国西电	COMPANY_OF_INDUSTRY_45
上海电气	COMPANY_OF_INDUSTRY_45
许继电气	COMPANY_OF_INDUSTRY_45
东北电气	COMPANY_OF_INDUSTRY_45
银河生物	COMPANY_OF_INDUSTRY_45
银星能源	COMPANY_OF_INDUSTRY_45
思源电气	COMPANY_OF_INDUSTRY_45
国轩高科	COMPANY_OF_INDUSTRY_45
三变科技	COMPANY_OF_INDUSTRY_45
深圳惠程	COMPANY_OF_INDUSTRY_45
智光电气	COMPANY_OF_INDUSTRY_45
艾派克	COMPANY_OF_INDUSTRY_45
金风科技	COMPANY_OF_INDUSTRY_45
奥特迅	COMPANY_OF_INDUSTRY_45
太阳电缆	COMPANY_OF_INDUSTRY_45
理工环科	COMPANY_OF_INDUSTRY_45
雅百特	COMPANY_OF_INDUSTRY_45
英威腾	COMPANY_OF_INDUSTRY_45
科华恒盛	COMPANY_OF_INDUSTRY_45
北京科锐	COMPANY_OF_INDUSTRY_45
森源电气	COMPANY_OF_INDUSTRY_45
中恒电气	COMPANY_OF_INDUSTRY_45
特锐德	COMPANY_OF_INDUSTRY_45
中元股份	COMPANY_OF_INDUSTRY_45
九洲电气	COMPANY_OF_INDUSTRY_45
合康变频	COMPANY_OF_INDUSTRY_45
中能电气	COMPANY_OF_INDUSTRY_45
金利华电	COMPANY_OF_INDUSTRY_45
恒顺众昇	COMPANY_OF_INDUSTRY_45
摩恩电气	COMPANY_OF_INDUSTRY_45
长高集团	COMPANY_OF_INDUSTRY_45
电科院	COMPANY_OF_INDUSTRY_45
大连电瓷	COMPANY_OF_INDUSTRY_45
中超控股	COMPANY_OF_INDUSTRY_45
南洋股份	COMPANY_OF_INDUSTRY_45
中利科技	COMPANY_OF_INDUSTRY_45
汉缆股份	COMPANY_OF_INDUSTRY_45
新联电子	COMPANY_OF_INDUSTRY_45
欣旺达	COMPANY_OF_INDUSTRY_45
科大智能	COMPANY_OF_INDUSTRY_45
明家联合	COMPANY_OF_INDUSTRY_45
四方股份	COMPANY_OF_INDUSTRY_45
正泰电器	COMPANY_OF_INDUSTRY_45
荣信股份	COMPANY_OF_INDUSTRY_45
万马股份	COMPANY_OF_INDUSTRY_45
金杯电工	COMPANY_OF_INDUSTRY_45
宝光股份	COMPANY_OF_INDUSTRY_45
宝胜股份	COMPANY_OF_INDUSTRY_45
永大集团	COMPANY_OF_INDUSTRY_45
通达股份	COMPANY_OF_INDUSTRY_45
向日葵	COMPANY_OF_INDUSTRY_45
科士达	COMPANY_OF_INDUSTRY_45
启源装备	COMPANY_OF_INDUSTRY_45
和顺电气	COMPANY_OF_INDUSTRY_45
风范股份	COMPANY_OF_INDUSTRY_45
齐星铁塔	COMPANY_OF_INDUSTRY_45
骆驼股份	COMPANY_OF_INDUSTRY_45
良信电器	COMPANY_OF_INDUSTRY_45
易事特	COMPANY_OF_INDUSTRY_45
泰胜风能	COMPANY_OF_INDUSTRY_45
金信诺	COMPANY_OF_INDUSTRY_45
智慧能源	COMPANY_OF_INDUSTRY_45
华锐风电	COMPANY_OF_INDUSTRY_45
广电电气	COMPANY_OF_INDUSTRY_45
麦迪电气	COMPANY_OF_INDUSTRY_45
科泰电源	COMPANY_OF_INDUSTRY_45
光一科技	COMPANY_OF_INDUSTRY_45
明星电缆	COMPANY_OF_INDUSTRY_45
远程电缆	COMPANY_OF_INDUSTRY_45
双杰电气	COMPANY_OF_INDUSTRY_45
圣阳股份	COMPANY_OF_INDUSTRY_45
吉鑫科技	COMPANY_OF_INDUSTRY_45
东方日升	COMPANY_OF_INDUSTRY_45
*欣泰	COMPANY_OF_INDUSTRY_45
节能风电	COMPANY_OF_INDUSTRY_45
通达动力	COMPANY_OF_INDUSTRY_45
鲁亿通	COMPANY_OF_INDUSTRY_45
红相电力	COMPANY_OF_INDUSTRY_45
杭电股份	COMPANY_OF_INDUSTRY_45
东方电缆	COMPANY_OF_INDUSTRY_45
通光线缆	COMPANY_OF_INDUSTRY_45
盛洋科技	COMPANY_OF_INDUSTRY_45
全信股份	COMPANY_OF_INDUSTRY_45
合纵科技	COMPANY_OF_INDUSTRY_45
通合科技	COMPANY_OF_INDUSTRY_45
华自科技	COMPANY_OF_INDUSTRY_45
金冠电气	COMPANY_OF_INDUSTRY_45
新宏泰	COMPANY_OF_INDUSTRY_45
卧龙电气	COMPANY_OF_INDUSTRY_45
白云电器	COMPANY_OF_INDUSTRY_45
蓝海华腾	COMPANY_OF_INDUSTRY_45
林海股份	COMPANY_OF_INDUSTRY_46
湖南天雁	COMPANY_OF_INDUSTRY_46
中国嘉陵	COMPANY_OF_INDUSTRY_46
*ST钱江	COMPANY_OF_INDUSTRY_46
宗申动力	COMPANY_OF_INDUSTRY_46
晋西车轴	COMPANY_OF_INDUSTRY_46
万安科技	COMPANY_OF_INDUSTRY_46
永贵电器	COMPANY_OF_INDUSTRY_46
南方汇通	COMPANY_OF_INDUSTRY_46
鼎汉技术	COMPANY_OF_INDUSTRY_46
中国中车	COMPANY_OF_INDUSTRY_46
康尼机电	COMPANY_OF_INDUSTRY_46
华铭智能	COMPANY_OF_INDUSTRY_46
神州高铁	COMPANY_OF_INDUSTRY_46
新元科技	COMPANY_OF_INDUSTRY_46
众合科技	COMPANY_OF_INDUSTRY_46
深中华A	COMPANY_OF_INDUSTRY_47
广博股份	COMPANY_OF_INDUSTRY_47
信隆实业	COMPANY_OF_INDUSTRY_47
齐心集团	COMPANY_OF_INDUSTRY_47
高乐股份	COMPANY_OF_INDUSTRY_47
骅威文化	COMPANY_OF_INDUSTRY_47
群兴玩具	COMPANY_OF_INDUSTRY_47
姚记扑克	COMPANY_OF_INDUSTRY_47
珠江钢琴	COMPANY_OF_INDUSTRY_47
美盛文化	COMPANY_OF_INDUSTRY_47
互动娱乐	COMPANY_OF_INDUSTRY_47
海伦钢琴	COMPANY_OF_INDUSTRY_47
全通教育	COMPANY_OF_INDUSTRY_47
凤凰光学	COMPANY_OF_INDUSTRY_47
中体产业	COMPANY_OF_INDUSTRY_47
新南洋	COMPANY_OF_INDUSTRY_47
上海凤凰	COMPANY_OF_INDUSTRY_47
中路股份	COMPANY_OF_INDUSTRY_47
晨光文具	COMPANY_OF_INDUSTRY_47
紫光学大	COMPANY_OF_INDUSTRY_47
长园集团	COMPANY_OF_INDUSTRY_48
诺德股份	COMPANY_OF_INDUSTRY_48
乐凯胶片	COMPANY_OF_INDUSTRY_48
黄河旋风	COMPANY_OF_INDUSTRY_48
*ST金瑞	COMPANY_OF_INDUSTRY_48
时代新材	COMPANY_OF_INDUSTRY_48
中国动力	COMPANY_OF_INDUSTRY_48
方大炭素	COMPANY_OF_INDUSTRY_48
宁波富邦	COMPANY_OF_INDUSTRY_48
鲁信创投	COMPANY_OF_INDUSTRY_48
万里股份	COMPANY_OF_INDUSTRY_48
英洛华	COMPANY_OF_INDUSTRY_48
瑞泰科技	COMPANY_OF_INDUSTRY_48
沃尔核材	COMPANY_OF_INDUSTRY_48
西部材料	COMPANY_OF_INDUSTRY_48
濮耐股份	COMPANY_OF_INDUSTRY_48
禾盛新材	COMPANY_OF_INDUSTRY_48
博云新材	COMPANY_OF_INDUSTRY_48
格林美	COMPANY_OF_INDUSTRY_48
神剑股份	COMPANY_OF_INDUSTRY_48
*ST鲁丰	COMPANY_OF_INDUSTRY_48
北京利尔	COMPANY_OF_INDUSTRY_48
大禹节水	COMPANY_OF_INDUSTRY_48
宝通科技	COMPANY_OF_INDUSTRY_48
钢研高纳	COMPANY_OF_INDUSTRY_48
新宙邦	COMPANY_OF_INDUSTRY_48
豫金刚石	COMPANY_OF_INDUSTRY_48
当升科技	COMPANY_OF_INDUSTRY_48
易成新能	COMPANY_OF_INDUSTRY_48
正海磁材	COMPANY_OF_INDUSTRY_48
裕兴股份	COMPANY_OF_INDUSTRY_48
银邦股份	COMPANY_OF_INDUSTRY_48
康得新	COMPANY_OF_INDUSTRY_48
长海股份	COMPANY_OF_INDUSTRY_48
开尔新材	COMPANY_OF_INDUSTRY_48
新莱应材	COMPANY_OF_INDUSTRY_48
康达新材	COMPANY_OF_INDUSTRY_48
海立美达	COMPANY_OF_INDUSTRY_48
上海新阳	COMPANY_OF_INDUSTRY_48
海润光伏	COMPANY_OF_INDUSTRY_48
完美世界	COMPANY_OF_INDUSTRY_48
隆基股份	COMPANY_OF_INDUSTRY_48
太空板业	COMPANY_OF_INDUSTRY_48
先锋新材	COMPANY_OF_INDUSTRY_48
德威新材	COMPANY_OF_INDUSTRY_48
江粉磁材	COMPANY_OF_INDUSTRY_48
四方达	COMPANY_OF_INDUSTRY_48
东材科技	COMPANY_OF_INDUSTRY_48
高盟新材	COMPANY_OF_INDUSTRY_48
道氏技术	COMPANY_OF_INDUSTRY_48
南大光电	COMPANY_OF_INDUSTRY_48
苏大维格	COMPANY_OF_INDUSTRY_48
中来股份	COMPANY_OF_INDUSTRY_48
石英股份	COMPANY_OF_INDUSTRY_48
立霸股份	COMPANY_OF_INDUSTRY_48
蓝思科技	COMPANY_OF_INDUSTRY_48
温州宏丰	COMPANY_OF_INDUSTRY_48
凯盛科技	COMPANY_OF_INDUSTRY_48
有研新材	COMPANY_OF_INDUSTRY_48
凯乐科技	COMPANY_OF_INDUSTRY_48
*ST烯碳	COMPANY_OF_INDUSTRY_48
三祥新材	COMPANY_OF_INDUSTRY_48
中直股份	COMPANY_OF_INDUSTRY_49
中国卫星	COMPANY_OF_INDUSTRY_49
洪都航空	COMPANY_OF_INDUSTRY_49
成发科技	COMPANY_OF_INDUSTRY_49
中航重机	COMPANY_OF_INDUSTRY_49
航天电子	COMPANY_OF_INDUSTRY_49
中航动力	COMPANY_OF_INDUSTRY_49
中航飞机	COMPANY_OF_INDUSTRY_49
海特高新	COMPANY_OF_INDUSTRY_49
光电股份	COMPANY_OF_INDUSTRY_49
中航电子	COMPANY_OF_INDUSTRY_49
航天科技	COMPANY_OF_INDUSTRY_49
航新科技	COMPANY_OF_INDUSTRY_49
中航机电	COMPANY_OF_INDUSTRY_49
航天通信	COMPANY_OF_INDUSTRY_49
耐威科技	COMPANY_OF_INDUSTRY_49
中航动控	COMPANY_OF_INDUSTRY_49
中航高科	COMPANY_OF_INDUSTRY_49
武钢股份	COMPANY_OF_INDUSTRY_50
包钢股份	COMPANY_OF_INDUSTRY_50
宝钢股份	COMPANY_OF_INDUSTRY_50
山东钢铁	COMPANY_OF_INDUSTRY_50
西宁特钢	COMPANY_OF_INDUSTRY_50
杭钢股份	COMPANY_OF_INDUSTRY_50
凌钢股份	COMPANY_OF_INDUSTRY_50
南钢股份	COMPANY_OF_INDUSTRY_50
酒钢宏兴	COMPANY_OF_INDUSTRY_50
抚顺特钢	COMPANY_OF_INDUSTRY_50
安阳钢铁	COMPANY_OF_INDUSTRY_50
*ST八钢	COMPANY_OF_INDUSTRY_50
新钢股份	COMPANY_OF_INDUSTRY_50
马钢股份	COMPANY_OF_INDUSTRY_50
柳钢股份	COMPANY_OF_INDUSTRY_50
重庆钢铁	COMPANY_OF_INDUSTRY_50
*ST钒钛	COMPANY_OF_INDUSTRY_50
金岭矿业	COMPANY_OF_INDUSTRY_50
大冶特钢	COMPANY_OF_INDUSTRY_50
河钢股份	COMPANY_OF_INDUSTRY_50
*ST韶钢	COMPANY_OF_INDUSTRY_50
本钢板材	COMPANY_OF_INDUSTRY_50
太钢不锈	COMPANY_OF_INDUSTRY_50
鞍钢股份	COMPANY_OF_INDUSTRY_50
华菱钢铁	COMPANY_OF_INDUSTRY_50
首钢股份	COMPANY_OF_INDUSTRY_50
三钢闽光	COMPANY_OF_INDUSTRY_50
*ST中特	COMPANY_OF_INDUSTRY_50
沙钢股份	COMPANY_OF_INDUSTRY_50
久立特材	COMPANY_OF_INDUSTRY_50
常宝股份	COMPANY_OF_INDUSTRY_50
方大特钢	COMPANY_OF_INDUSTRY_50
山东地矿	COMPANY_OF_INDUSTRY_50
华联矿业	COMPANY_OF_INDUSTRY_50
海南矿业	COMPANY_OF_INDUSTRY_50
日上集团	COMPANY_OF_INDUSTRY_50
永兴特钢	COMPANY_OF_INDUSTRY_50
鄂尔多斯	COMPANY_OF_INDUSTRY_50
新疆天业	COMPANY_OF_INDUSTRY_51
*ST江泉	COMPANY_OF_INDUSTRY_51
复旦复华	COMPANY_OF_INDUSTRY_51
同达创业	COMPANY_OF_INDUSTRY_51
申华控股	COMPANY_OF_INDUSTRY_51
*ST工新	COMPANY_OF_INDUSTRY_51
中国高科	COMPANY_OF_INDUSTRY_51
综艺股份	COMPANY_OF_INDUSTRY_51
东方集团	COMPANY_OF_INDUSTRY_51
同济科技	COMPANY_OF_INDUSTRY_51
中炬高新	COMPANY_OF_INDUSTRY_51
东方市场	COMPANY_OF_INDUSTRY_51
三木集团	COMPANY_OF_INDUSTRY_51
泰达股份	COMPANY_OF_INDUSTRY_51
大连国际	COMPANY_OF_INDUSTRY_51
中钢天源	COMPANY_OF_INDUSTRY_51
宁波联合	COMPANY_OF_INDUSTRY_51
力合股份	COMPANY_OF_INDUSTRY_51
数源科技	COMPANY_OF_INDUSTRY_51
天宸股份	COMPANY_OF_INDUSTRY_51
*ST新亿	COMPANY_OF_INDUSTRY_52
中国巨石	COMPANY_OF_INDUSTRY_52
三峡新材	COMPANY_OF_INDUSTRY_52
山东药玻	COMPANY_OF_INDUSTRY_52
金晶科技	COMPANY_OF_INDUSTRY_52
福耀玻璃	COMPANY_OF_INDUSTRY_52
耀皮玻璃	COMPANY_OF_INDUSTRY_52
洛阳玻璃	COMPANY_OF_INDUSTRY_52
南玻A	COMPANY_OF_INDUSTRY_52
中材科技	COMPANY_OF_INDUSTRY_52
鲁阳节能	COMPANY_OF_INDUSTRY_52
悦心健康	COMPANY_OF_INDUSTRY_52
中航三鑫	COMPANY_OF_INDUSTRY_52
九鼎新材	COMPANY_OF_INDUSTRY_52
文化长城	COMPANY_OF_INDUSTRY_52
亚玛顿	COMPANY_OF_INDUSTRY_52
德力股份	COMPANY_OF_INDUSTRY_52
金刚玻璃	COMPANY_OF_INDUSTRY_52
秀强股份	COMPANY_OF_INDUSTRY_52
菲利华	COMPANY_OF_INDUSTRY_52
再升科技	COMPANY_OF_INDUSTRY_52
松发股份	COMPANY_OF_INDUSTRY_52
旗滨集团	COMPANY_OF_INDUSTRY_52
山东华鹏	COMPANY_OF_INDUSTRY_52
四通股份	COMPANY_OF_INDUSTRY_52
安彩高科	COMPANY_OF_INDUSTRY_52
弘业股份	COMPANY_OF_INDUSTRY_53
建发股份	COMPANY_OF_INDUSTRY_53
华升股份	COMPANY_OF_INDUSTRY_53
时代万恒	COMPANY_OF_INDUSTRY_53
东方创业	COMPANY_OF_INDUSTRY_53
广东明珠	COMPANY_OF_INDUSTRY_53
申达股份	COMPANY_OF_INDUSTRY_53
物产中大	COMPANY_OF_INDUSTRY_53
新华锦	COMPANY_OF_INDUSTRY_53
厦门国贸	COMPANY_OF_INDUSTRY_53
上海物贸	COMPANY_OF_INDUSTRY_53
兰生股份	COMPANY_OF_INDUSTRY_53
汇鸿集团	COMPANY_OF_INDUSTRY_53
中成股份	COMPANY_OF_INDUSTRY_53
如意集团	COMPANY_OF_INDUSTRY_53
江苏国泰	COMPANY_OF_INDUSTRY_53
怡亚通	COMPANY_OF_INDUSTRY_53
五矿发展	COMPANY_OF_INDUSTRY_53
浙江东方	COMPANY_OF_INDUSTRY_53
国机汽车	COMPANY_OF_INDUSTRY_53
中国石化	COMPANY_OF_INDUSTRY_54
延长化建	COMPANY_OF_INDUSTRY_54
*ST天利	COMPANY_OF_INDUSTRY_54
海越股份	COMPANY_OF_INDUSTRY_54
上海石化	COMPANY_OF_INDUSTRY_54
中海油服	COMPANY_OF_INDUSTRY_54
中国石油	COMPANY_OF_INDUSTRY_54
广聚能源	COMPANY_OF_INDUSTRY_54
泰山石油	COMPANY_OF_INDUSTRY_54
茂化实华	COMPANY_OF_INDUSTRY_54
沈阳化工	COMPANY_OF_INDUSTRY_54
岳阳兴长	COMPANY_OF_INDUSTRY_54
大庆华科	COMPANY_OF_INDUSTRY_54
准油股份	COMPANY_OF_INDUSTRY_54
东华能源	COMPANY_OF_INDUSTRY_54
陕天然气	COMPANY_OF_INDUSTRY_54
国创高新	COMPANY_OF_INDUSTRY_54
惠博普	COMPANY_OF_INDUSTRY_54
仁智油服	COMPANY_OF_INDUSTRY_54
国际实业	COMPANY_OF_INDUSTRY_54
通源石油	COMPANY_OF_INDUSTRY_54
龙宇燃油	COMPANY_OF_INDUSTRY_54
潜能恒信	COMPANY_OF_INDUSTRY_54
恒泰艾普	COMPANY_OF_INDUSTRY_54
中天能源	COMPANY_OF_INDUSTRY_54
石化油服	COMPANY_OF_INDUSTRY_54
高科石化	COMPANY_OF_INDUSTRY_54
广汇能源	COMPANY_OF_INDUSTRY_54
新潮能源	COMPANY_OF_INDUSTRY_54
华信国际	COMPANY_OF_INDUSTRY_54
美都能源	COMPANY_OF_INDUSTRY_54
洲际油气	COMPANY_OF_INDUSTRY_54
海顺新材	COMPANY_OF_INDUSTRY_55
上海绿新	COMPANY_OF_INDUSTRY_55
大东南	COMPANY_OF_INDUSTRY_55
紫江企业	COMPANY_OF_INDUSTRY_55
盛通股份	COMPANY_OF_INDUSTRY_55
永新股份	COMPANY_OF_INDUSTRY_55
通产丽星	COMPANY_OF_INDUSTRY_55
新通联	COMPANY_OF_INDUSTRY_55
珠海中富	COMPANY_OF_INDUSTRY_55
王子新材	COMPANY_OF_INDUSTRY_55
万顺股份	COMPANY_OF_INDUSTRY_55
陕西金叶	COMPANY_OF_INDUSTRY_55
东风股份	COMPANY_OF_INDUSTRY_55
宝钢包装	COMPANY_OF_INDUSTRY_55
界龙实业	COMPANY_OF_INDUSTRY_55
美盈森	COMPANY_OF_INDUSTRY_55
双星新材	COMPANY_OF_INDUSTRY_55
鸿博股份	COMPANY_OF_INDUSTRY_55
东港股份	COMPANY_OF_INDUSTRY_55
浙江众成	COMPANY_OF_INDUSTRY_55
华源包装	COMPANY_OF_INDUSTRY_55
合兴包装	COMPANY_OF_INDUSTRY_55
劲嘉股份	COMPANY_OF_INDUSTRY_55
农业银行	COMPANY_OF_INDUSTRY_56
光大银行	COMPANY_OF_INDUSTRY_56
平安银行	COMPANY_OF_INDUSTRY_56
宁波银行	COMPANY_OF_INDUSTRY_56
浦发银行	COMPANY_OF_INDUSTRY_56
华夏银行	COMPANY_OF_INDUSTRY_56
民生银行	COMPANY_OF_INDUSTRY_56
招商银行	COMPANY_OF_INDUSTRY_56
南京银行	COMPANY_OF_INDUSTRY_56
兴业银行	COMPANY_OF_INDUSTRY_56
北京银行	COMPANY_OF_INDUSTRY_56
交通银行	COMPANY_OF_INDUSTRY_56
工商银行	COMPANY_OF_INDUSTRY_56
建设银行	COMPANY_OF_INDUSTRY_56
中国银行	COMPANY_OF_INDUSTRY_56
中信银行	COMPANY_OF_INDUSTRY_56
江苏银行	COMPANY_OF_INDUSTRY_56
瑞贝卡	COMPANY_OF_INDUSTRY_57
熊猫金控	COMPANY_OF_INDUSTRY_57
青岛金王	COMPANY_OF_INDUSTRY_57
新海股份	COMPANY_OF_INDUSTRY_57
邦宝益智	COMPANY_OF_INDUSTRY_57
黄山旅游	COMPANY_OF_INDUSTRY_58
中青旅	COMPANY_OF_INDUSTRY_58
首旅酒店	COMPANY_OF_INDUSTRY_58
国旅联合	COMPANY_OF_INDUSTRY_58
海航创新	COMPANY_OF_INDUSTRY_58
大连圣亚	COMPANY_OF_INDUSTRY_58
西藏旅游	COMPANY_OF_INDUSTRY_58
锦江股份	COMPANY_OF_INDUSTRY_58
金陵饭店	COMPANY_OF_INDUSTRY_58
中国国旅	COMPANY_OF_INDUSTRY_58
华天酒店	COMPANY_OF_INDUSTRY_58
张家界	COMPANY_OF_INDUSTRY_58
岭南控股	COMPANY_OF_INDUSTRY_58
西安旅游	COMPANY_OF_INDUSTRY_58
大东海A	COMPANY_OF_INDUSTRY_58
西安饮食	COMPANY_OF_INDUSTRY_58
峨眉山A	COMPANY_OF_INDUSTRY_58
桂林旅游	COMPANY_OF_INDUSTRY_58
丽江旅游	COMPANY_OF_INDUSTRY_58
三特索道	COMPANY_OF_INDUSTRY_58
全聚德	COMPANY_OF_INDUSTRY_58
中科云网	COMPANY_OF_INDUSTRY_58
宋城演艺	COMPANY_OF_INDUSTRY_58
曲江文旅	COMPANY_OF_INDUSTRY_58
云南旅游	COMPANY_OF_INDUSTRY_58
号百控股	COMPANY_OF_INDUSTRY_58
全新好	COMPANY_OF_INDUSTRY_58
众信旅游	COMPANY_OF_INDUSTRY_58
腾邦国际	COMPANY_OF_INDUSTRY_58
北部湾旅	COMPANY_OF_INDUSTRY_58
九华旅游	COMPANY_OF_INDUSTRY_58
长白山	COMPANY_OF_INDUSTRY_58
新华保险	COMPANY_OF_INDUSTRY_59
中国平安	COMPANY_OF_INDUSTRY_59
中国太保	COMPANY_OF_INDUSTRY_59
中国人寿	COMPANY_OF_INDUSTRY_59
东方园林	COMPANY_OF_INDUSTRY_60
岭南园林	COMPANY_OF_INDUSTRY_60
棕榈股份	COMPANY_OF_INDUSTRY_60
云投生态	COMPANY_OF_INDUSTRY_60
蒙草生态	COMPANY_OF_INDUSTRY_60
铁汉生态	COMPANY_OF_INDUSTRY_60
中毅达	COMPANY_OF_INDUSTRY_60
美晨科技	COMPANY_OF_INDUSTRY_60
美丽生态	COMPANY_OF_INDUSTRY_60
普邦园林	COMPANY_OF_INDUSTRY_60
花王股份	COMPANY_OF_INDUSTRY_60
电力	INDUSTRY-40
电信	INDUSTRY-2
电子元件	INDUSTRY-32
民航	INDUSTRY-1
保险	INDUSTRY-59
塑胶	INDUSTRY-25
交运设备	INDUSTRY-46
白银	INDUSTRY-0
园林	INDUSTRY-60
房地产	INDUSTRY-30
楼市	INDUSTRY-30
房价	INDUSTRY-30
住房	INDUSTRY-30
旅游酒店	INDUSTRY-58
银行	INDUSTRY-56
央行	INDUSTRY-56
通胀	INDUSTRY-56
CPI	INDUSTRY-56
GDP	INDUSTRY-56
黄金	INDUSTRY-0
造纸	INDUSTRY-11
农牧饲渔	INDUSTRY-34
航天航空	INDUSTRY-49
化纤	INDUSTRY-19
化工	INDUSTRY-24
电子信息	INDUSTRY-35
船舶	INDUSTRY-21
纺织服装	INDUSTRY-23
机械	INDUSTRY-33
化肥	INDUSTRY-9
综合行业	INDUSTRY-51
高速公路	INDUSTRY-42
国际贸易	INDUSTRY-53
外汇	INDUSTRY-53
外贸	INDUSTRY-53
汇率	INDUSTRY-53
美联储	INDUSTRY-53
通胀	INDUSTRY-53
量化宽松	INDUSTRY-53
铂金	INDUSTRY-0
仪器仪表	INDUSTRY-20
文化传媒	INDUSTRY-26
装修装饰	INDUSTRY-39
多元金融	INDUSTRY-44
公用事业	INDUSTRY-17
通讯	INDUSTRY-37
包装材料	INDUSTRY-55
券商	INDUSTRY-18
煤炭	INDUSTRY-7
港口	INDUSTRY-29
家电	INDUSTRY-8
输配电气	INDUSTRY-45
工程建设	INDUSTRY-41
医疗	INDUSTRY-13
制药  INDUSTRY-13
有色金属	INDUSTRY-10
家具	INDUSTRY-16
汽车	INDUSTRY-5
食品	INDUSTRY-6
乳业	INDUSTRY-6
农作物	INDUSTRY-6
农产品	INDUSTRY-6
软件	INDUSTRY-31
文教休闲	INDUSTRY-47
信托	INDUSTRY-18
债券  INDUSTRY-18
国债  INDUSTRY-18
股债  INDUSTRY-18
信贷  INDUSTRY-18
利率  INDUSTRY-18
衍生品  INDUSTRY-18
百货	INDUSTRY-28
环保	INDUSTRY-3
石油	INDUSTRY-54
天然气	INDUSTRY-54
油价	INDUSTRY-54
原油	INDUSTRY-54
农药兽药	INDUSTRY-38
物流	INDUSTRY-36
玻璃陶瓷	INDUSTRY-52
金属制品	INDUSTRY-43
医药	INDUSTRY-12
珠宝	INDUSTRY-14
钢铁	INDUSTRY-50
安防	INDUSTRY-15
互联网	INDUSTRY-31
智能  INDUSTRY-31
科技  INDUSTRY-31
机器人  INDUSTRY-31
无人  INDUSTRY-31
自动  INDUSTRY-31
酿酒	INDUSTRY-4
工艺商品	INDUSTRY-57
水泥	INDUSTRY-22
贵金属	INDUSTRY-0
材料行业	INDUSTRY-48
专用设备	INDUSTRY-27
王健林	PERSON-1
马云	PERSON-2
马化腾	PERSON-3
雷军	PERSON-4
王文银	PERSON-5
李彦宏	PERSON-6
何享健	PERSON-7
许家印	PERSON-8
刘强东	PERSON-9
丁磊	PERSON-10
郭广昌	PERSON-11
宗庆后	PERSON-12
鲁冠球	PERSON-13
魏建军	PERSON-14
张志东	PERSON-15
陈丽华	PERSON-16
贾跃亭	PERSON-17
周群飞	PERSON-18
刘永行	PERSON-19
周建平	PERSON-20
王传福	PERSON-21
孙广信	PERSON-22
龚虹嘉	PERSON-23
杨惠妍	PERSON-24
许荣茂	PERSON-25
刘永好	PERSON-26
李河君	PERSON-27
张近东	PERSON-28
卢志强	PERSON-29
童锦泉	PERSON-30
梁稳根	PERSON-31
王文学	PERSON-32
王卫	PERSON-33
黄如论	PERSON-34
庞康	PERSON-35
邱光和	PERSON-36
孙飘扬	PERSON-37
李书福	PERSON-38
汪滔	PERSON-39
张士平	PERSON-40
吕向阳	PERSON-41
潘政民	PERSON-42
吴亚军	PERSON-43
周国辉	PERSON-44
叶澄海	PERSON-45
马建荣	PERSON-46
王玉锁	PERSON-47
杨凯	PERSON-48
史玉柱	PERSON-49
薛光林	PERSON-51
于泳	PERSON-52
姜滨	PERSON-53
王长田	PERSON-54
陈发树	PERSON-55
车建新	PERSON-56
林秀成	PERSON-57
谢世煌	PERSON-58
何巧女	PERSON-59
黄伟	PERSON-60
谢炳	PERSON-61
傅利泉	PERSON-62
黄世再	PERSON-63
柯尊洪	PERSON-64
李仲初	PERSON-65
陆风	PERSON-66
黄文集	PERSON-67
梁信军	PERSON-68
秦英林	PERSON-69
王靖	PERSON-70
张欣	PERSON-71
蔡东青	PERSON-72
刘晓东	PERSON-73
施文博	PERSON-74
周奕丰	PERSON-75
刘忠田	PERSON-76
沈国军	PERSON-77
宋作文	PERSON-78
许连捷	PERSON-79
李锂	PERSON-80
王文京	PERSON-81
周成建	PERSON-82
陈建华	PERSON-83
王兴	PERSON-84
吴光明	PERSON-85
熊续强	PERSON-86
姜伟	PERSON-87
刘志强	PERSON-88
杜江涛	PERSON-89
蔡奎	PERSON-90
周亚辉	PERSON-91
马兴田	PERSON-92
沈文荣	PERSON-93
曹龙祥	PERSON-94
陈邦	PERSON-95
薛向东	PERSON-96
阎志	PERSON-97
杨铿	PERSON-98
纪海鹏	PERSON-99
黄联禧	PERSON-100